Xu, Xu, Xu, Xu, Xu, Xu, Xu, Xu, Xu, Xu, Xu, Xu, Xu
Xu, Xu, Xu, Xu, Xu, Xu, Rr, Xu, Xu, Xu, Xu, Xu, Xu
Xu, Xu, Xu, Xu, Ur, Rr, Rr, Rr, Ur, Xu, Xu, Xu, Xu
Xu, Xu, Xu, Ur, Ur, Rr, Rr, Rr, Ur, Ur, Xu, Xu, Xu
Xu, Xu, Xu, Ur, Ur, Ur, Ur, Ur, Ur, Ur, Xu, Xu, Xu
Xu, Xu, Xu, Xu, Xos, Ur, Ur, Ur, Xos, Xu, Xu, Xu, Xu
Xu, Xu, Xu, Xu, Ur^Ebn, Ur, Ur, Ur, Ur^Ebn, Xu, Xu, Xu, Xu
Xu, Xu, Xu, Ur, Ur, Ur, Ur, Ur, Ur, Ur, Xu, Xu, Xu
Xu, Xu, Xu, Ur, Ur, Ur, Ur, Ur, Ur, Ur, Xu, Xu, Xu
Xu, Xu, Xu, Ur, Ur, Ur, Ur^Ii, Ur, Ur, Ur, Xu, Xu, Xu
Xu, Xu, Xu, Xu, Xu, Ur^Ii, 1 Ur^Ii, Ur^Ii, Xu, Xu, Xu, Xu, Xu
Xu, Xu, Xu, Xu, Xu, Xu, Xu, Xu, Xu, Xu, Xu, Xu, Xu
