Xoc, Xoc, Xoc, Xoc, Xoc, Xoc, Xoc, Xoc, Xoc, Xoc, Xoc, Xoc, Xoc
Xoc, Xoc, Xoc, Xoc, Xoc, Xoc, Rra, Xoc, Xoc, Xoc, Xoc, Xoc, Xoc
Xoc, Xoc, Xoc, Xoc, Ai, Rra, Rra, Rra, Ai, Xoc, Xoc, Xoc, Xoc
Xoc, Xoc, Ai, Ai, Ai, Rra, Rra, Rra, Ai, Ai, Ai, Xoc, Xoc
Xoc, Xoc, Ai, Ai, Ai, Ai, Ai, Ai, Ai, Ai, Ai, Xoc, Xoc
Xoc, Xoc, Ai, Ai, Ai, Ai, Ai, Ai, Ai, Ai, Ai, Xoc, Xoc
Xoc, Xoc, Ai, Ai, Ai, Ai, Ai, Ai, Ai, Ai, Ai, Xoc, Xoc
Xoc, Xoc, Ai, Ai, Ai, Ai, Ai, Ai, Ai, Ai, Ai, Xoc, Xoc
Xoc, Xoc, Ai, Ai, Ai, Ai, Ai, Ai, Ai, Ai, Ai, Xoc, Xoc
Xoc, Xoc, Xoc, Ai, Ai, Ai, Ur^Ii, Ai, Ai, Ai, Xoc, Xoc, Xoc
Xoc, Xoc, Xoc, Xoc, Xoc, Ur^Ii, 1 Ur^Ii, Ur^Ii, Xoc, Xoc, Xoc, Xoc, Xoc
Xoc, Xoc, Xoc, Xoc, Xoc, Xoc, Xoc, Xoc, Xoc, Xoc, Xoc, Xoc, Xoc
