Xue, Xue, Xue, Xue, Xue, Xue, Xue, Xue, Xue, Xue, Xue, Xue, Xue
Xue, Xue, Xue, Xue, Xue, Xue, Rp, Xue, Xue, Xue, Xue, Xue, Xue
Xue, Xue, Xue, Xue, Re, Rp, Rp, Rp, Re, Xue, Xue, Xue, Xue
Xue, Xue, Gll^Ftr, Gll^Ftr, Re, Rp, Rp, Rp, Re, Gll^Ftr, Gll^Ftr, Xue, Xue
Xue, Xue, Gll^Ftr, Gll, Gll^Ftr, Re, Re, Re, Gll^Ftr, Gll, Gll^Ftr, Xue, Xue
Xue, Xue, Gll, Gll, Gll^Ftr, Gll^Ftr, Gll, Gll^Ftr, Gll^Ftr, Gll, Gll, Xue, Xue
Xue, Xue, Gll, Gll, Gll, Gll^Ftr, Gll, Gll^Ftr, Gll, Gll, Gll, Xue, Xue
Xue, Xue, Gll^Ftr, Gll, Gll^Ftr, Gll, Gll, Gll, Gll^Ftr, Gll, Gll^Ftr, Xue, Xue
Xue, Xue, Gll^Ftr, Gll, Gll, Gll, Re, Gll, Gll, Gll, Gll^Ftr, Xue, Xue
Xue, Xue, Xue, Gll^Ftr, Re, Re, Ur^Ii, Re, Re, Gll^Ftr, Xue, Xue, Xue
Xue, Xue, Xue, Xue, Xue, Ur^Ii, 1 Ur^Ii, Ur^Ii, Xue, Xue, Xue, Xue, Xue
Xue, Xue, Xue, Xue, Xue, Xue, Xue, Xue, Xue, Xue, Xue, Xue, Xue
