Qxua, Qxua, Qxua, Qxua, Qxua, Qxua, Qxua, Qxua, Qxua, Qxua, Qxua, Qxua, Qxua
Qxua, Qxua, Qxua, Qxua, Mdd, Qxua, Ur, Qxua, Mdd, Qxua, Qxua, Qxua, Qxua
Qxua, Qxua, Qxua, Mdd, Uu, Ur, Ur, Ur, Uu, Mdd, Qxua, Qxua, Qxua
Qxua, Qxua, Uu, Uu, Uu, Ur, Ur, Ur, Uu, Uu, Uu, Qxua, Qxua
Qxua, Mdd, Uu, Mdd, Mdd, Uu, Uu, Uu, Mdd, Mdd, Uu, Mdd, Qxua
Qxua, Qxua, Uu, Mdd, Uu, Uu, Qxua, Uu, Uu, Mdd, Uu, Qxua, Qxua
Qxua, Qxua, Uu, Uu, Mdd, Uu, Qxua, Uu, Mdd, Uu, Uu, Qxua, Qxua
Qxua, Qxua, Mdd, Uu, Uu, Uu, Uu, Uu, Uu, Uu, Mdd, Qxua, Qxua
Qxua, Qxua, Qxua, Qxua, Uu, Uu, Uu, Uu, Uu, Qxua, Qxua, Qxua, Qxua
Qxua, Qxua, Mdd, Uu, Uu, Uu, Ur^Ii, Uu, Uu, Uu, Mdd, Qxua, Qxua
Qxua, Qxua, Qxua, Uu, Qxua, Ur^Ii, 1 Ur^Ii, Ur^Ii, Qxua, Uu, Qxua, Qxua, Qxua
Qxua, Qxua, Qxua, Qxua, Qxua, Qxua, Qxua, Qxua, Qxua, Qxua, Qxua, Qxua, Qxua
