Xyui, Xyui, Xyui, Xyui, Xyui, Xyui, Xyui, Xyui, Xyui, Xyui, Xyui, Xyui, Xyui
Xyui, Xyui, Xyui, Xyui, Xyui, Xyui, Xyui, Xyui, Xyui, Xyui, Xyui, Xyui, Xyui
Xyui, Xyui, Qxaz, Qxaz, Ai, Ds, Ds, Ds, Ai, Qxaz, Qxaz, Xyui, Xyui
Xyui, Xyui, Qxaz, Ai, Ww, Ds, Ds, Ds, Wwf, Ai, Ai, Xyui, Xyui
Xyui, Xyui, Ai, Ai, Ds, Wwf, Wwf, Wwf, Ww, Ww, Ww, Xyui, Xyui
Xyui, Xyui, Ww, Ds, Ds, Wwf, Ai, Wwf, Wwf, Ai, Ww, Xyui, Xyui
Xyui, Xyui, Ww, Ds, Wwf, Wwf, Qxaz, Qxaz, Wwf, Ai, Ww, Xyui, Xyui
Xyui, Xyui, Ds, Ww, Wwf, Ai, Qxaz, Ai, Wwf, Wwf, Aa, Xyui, Xyui
Xyui, Xyui, Aa, Ds, Ds, Ai, Ai, Ai, Ds, Ds, Aa, Xyui, Xyui
Xyui, Xyui, Xyui, Aa, Aa, Ds, Rra, Ds, Aa, Aa, Xyui, Xyui, Xyui
Xyui, Xyui, Xyui, Xyui, Xyui, Rra, 1 Rra, Rra, Xyui, Xyui, Xyui, Xyui, Xyui
Xyui, Xyui, Xyui, Xyui, Xyui, Xyui, Xyui, Xyui, Xyui, Xyui, Xyui, Xyui, Xyui
