Xyui, Xyui, Xyui, Xyui, Xyui, Xyui, Xyui, Xyui, Xyui, Xyui, Xyui, Xyui, Xyui
Xyui, Xyui, Xyui, Xyui, Xyui, Xyui, Xyui, Xyui, Xyui, Xyui, Xyui, Xyui, Xyui
Xyui, Xyui, Xyui, Xyui, Wwf^Tf, Aa^Emf, Aa, Uyi, Aa, Xyui, Xyui, Xyui, Xyui
Xyui, Xyui, Uyi^Tf, Aa^Tf, Xyui, Ai, Aa, Aa, Wwf^Emf, Ai, Ai, Xyui, Xyui
Xyui, Xyui, Aa^Tf, Aa^Tf, Ai, Aa, Ai, Xyui, Wwf^Tf, Qxaz, Ai^Emf, Xyui, Xyui
Xyui, Xyui, Aa^Emf, Ai, Ai, Ai, Ai, Xyui, Xyui, Ai, Ai, Xyui, Xyui
Xyui, Xyui, Uyi, Xyui, Xyui, Ai, Aa, Ai, Qxaz, Ai, Aa^Tf, Xyui, Xyui
Xyui, Xyui, Uyi, Qxaz, Xyui, Aa^Esa, Ai, Qxaz, Qxaz, Aa^Emf, Uyi^Emf, Xyui, Xyui
Xyui, Xyui, Aa, Aa^Esa, Aa, Ai^Emf, Ai, Qxaz, Aa, Aa, Uyi, Xyui, Xyui
Xyui, Xyui, Xyui, Wwf, Aa, Aa, Rra, Aa, Aa^Esa, Uyi, Xyui, Xyui, Xyui
Xyui, Xyui, Xyui, Xyui, Xyui, Rra, 1 Rra, Rra, Xyui, Xyui, Xyui, Xyui, Xyui
Xyui, Xyui, Xyui, Xyui, Xyui, Xyui, Xyui, Xyui, Xyui, Xyui, Xyui, Xyui, Xyui
