Xoa, Xoa, Xoa, Xoa, Xoa, Xoa, Urb, Xoa, Xoa, Xoa, Xoa, Xoa, Xoa
Xoa, Xoa, Xoa, Xoa, Uu, Uu, Urb, Uu, Uu, Xoa, Xoa, Xoa, Xoa
Xoa, Xoa, Uu, Uu, Uu, Uu, Urb, Uu, Uu, Uu, Uu, Xoa, Xoa
Xoa, Uu, Uu, Uu, Xoa, Uu, Urb, Uu, Xoa, Uu, Uu, Uu, Xoa
Xoa, Uu, Qxu, Uu, Uu, Uu, Urb, Uu, Uu, Uu, Qxu, Uu, Xoa
Xoa, Uu, Qxu, Qxu, Uu, Cud, Kud^Ii, Cud, Uu, Qxu, Qxu, Uu, Xoa
Xoa, Uu, Qxu, Qxu, Uu, Urb, Cud, Urb, Uu, Qxu, Qxu, Uu, Xoa
Xoa, Uu, Uu, Uu, Xoa, Uu^Ebn, Urb, Uu^Ebn, Xoa, Uu, Uu, Uu, Xoa
Xoa, Uu, Uu, Uu, Uu, Uu, Urb, Uu, Uu, Uu, Uu, Uu, Xoa
Xoa, Xoa, Xoa, Uu, Uu, Uu, Urb^Ii, Uu, Uu, Uu, Xoa, Xoa, Xoa
Xoa, Xoa, Xoa, Xoa, Xoa, Ur^Ii, 1 Urb^Ii, Ur^Ii, Xoa, Xoa, Xoa, Xoa, Xoa
Xoa, Xoa, Xoa, Xoa, Xoa, Xoa, Urb, Xoa, Xoa, Xoa, Xoa, Xoa, Xoa
