Xu, Xu, Xu, Xu, Xuc, Xuc, Xuc, Xuc, Xuc, Xu, Xu, Xu, Xu
Xu, Xu, Xuc, Xuc, Uu, Uu, Uu, Uu, Uu, Xuc, Xuc, Xuc, Xu
Xu, Xuc, Uu, Uu, Uu, Xuc^Efs, Uu, Xuc^Efs, Uu, Uu, Uu, Xuc, Xuc
Uu^Br\, Xuc, Uu, Uu, Xuc, Uu, Uu, Uu, Xuc, Xuc, Uu, Uu, Xuc
Xuc, Uu^Br\, Uu^Br\, Uu, Uu^Br\, Xuc, Uu, Uu, Xuc^Efs, Uu, Qxu, Qxu^Bp|, Qxu^Bp/
Qxu, Qxu, Qxu^Bp/, Uu^Br/, Xuc^Efs, Uu^Br\, Uu^Br\, Uu, Xuc^Efs, Uu^Br|, Qxu^Bp/, Qxu^Bp/, Qxu
Qxu^Bp/, Qxu^Bp/, Qxu, Uu^Br|, Xuc^Efs, Uu, Uu, Uu^Br\, Uu^Br/, Uu^Br\, Uu^Br\, Qxu, Xu
Xuc, Qxu^Bp|, Uu, Uu, Xuc, Uu, Uu, Xuc, Xuc, Uu, Uu, Uu^Br\, Uu^Br\
Xuc, Uu, Uu, Xuc, Uu, Uu, Uu, Uu, Uu, Uu, Uu, Xuc, Xu
Xu, Xuc, Xuc, Uu, Uu, Xuc^Efs, Ur^Ii, Xuc^Efs, Uu, Uu, Xuc, Xuc, Xu
Xu, Xu, Xu, Xuc, Xuc, Ur^Ii, 1 Ur^Ii, Ur^Ii, Xuc, Xuc, Xu, Xu, Xu
Xu, Xu, Xu, Xu, Xu, Xuc, Xuc, Xuc, Xu, Xu, Xu, Xu, Xu
