Xu, Xu, Xu, Xu, Xoa, Uu, Urb, Uu, Xoa, Xu, Xu, Xu, Xu
Xu, Xu, Xu, Xu, Uu, Uu, Urb, Uu, Uu, Xu, Xu, Xu, Xu
Xu, Xu, Qxu, Uu, Uu, Uu, Urb, Uu, Uu, Uu, Qxu, Xu, Xu
Qxu, Qxu, Qxu, Uu, Qxu, Qxu, Qxu^Bcx|, Qxu, Qxu, Uu, Qxu, Qxu, Qxu
Qxu, Qxu, Uu, Uu, Xoa, Qxu, Urb, Qxu, Xoa, Uu, Uu, Qxu, Qxu
Qxu, Qxu, Uu, Uu, Uu^Ebn, Cud, Kud, Cud, Uu^Ebn, Uu, Uu, Qxu, Qxu
Qxu, Qxu, Uu, Uu, Uu, Uu, Urb, Uu, Uu, Uu, Uu, Qxu, Qxu
Qxu, Qxu, Qxu^Bcx|, Qxu, Qxu, Uu, Urb, Uu, Qxu, Qxu, Qxu^Bcx|, Qxu, Qxu
Qxu, Qxu, Qxu^Bcx|, Qxu, Qxu, Qxu, Qxu^Bcx|, Qxu, Qxu, Qxu, Qxu^Bcx|, Qxu, Qxu
Xu, Qxu, Qxu^Bcx|, Uu, Uu, Uu, Urb^Ii, Uu, Uu, Uu, Qxu^Bcx|, Qxu, Xu
Xu, Xu, Xu, Xoa, Xoa, Ur^Ii, 1 Urb^Ii, Ur^Ii, Xoa, Xoa, Xu, Xu, Xu
Xu, Xu, Xu, Xu, Xoa, Uu, Urb, Uu, Xoa, Xu, Xu, Xu, Xu
