Xue, Xue, Xue, Xue, Xue, Xos, Xue, Xue, Xue, Xue, Xue, Xue, Xue
Xue, Xue, Xue, Xue, Xue, Xue, Rd, Xue, Xue, Xue, Xue, Xue, Xue
Xue, Xue, Xue, Xue, Dd, Rd, Rd, Rd, Dd^Edp, Xue, Xue, Xue, Xue
Xue, Xue, Dd, Dd, Dd^Edp, Dd, Dd, Dd, Dd, Dd, Dd, Xue, Xue
Xue, Xue, Dd, Dd^Dc, Dd, Dd, Dd, Qxe, Dd, Dd^Dc, Dd, Xue, Xue
Xu, Xue, Dd, Dd, Qxe, Dd, Dd, Dd, Qxe, Dd, Qxe, Xue, Xue
Xu, Xue, Qxe, Dd, Qxe, Qxe, Dd, Qxe, Qxe, Dd, Dd, Xue, Xue
Xu, Xue, Dd, Dd, Dd, Dd, Dd, Dd, Dd, Dd, Dd, Xue, Xue
Xue, Xue, Dd, Dd^Dc, Dd, Qxe, Dd, Dd^Edp, Dd, Dd^Dc, Dd, Xue, Xue
Xue, Xue, Xue, Dd, Dd, Dd, Rd^Ii, Dd, Dd, Dd, Xue, Xue, Xue
Xue, Xue, Xue, Xue, Xue, Rd^Ii, 1 Rd^Ii, Rd^Ii, Xue, Xue, Xue, Xue, Xue
Xue, Xue, Xue, Xue, Xue, Xue, Xue, Xue, Xue, Xue, Xue, Xue, Xue
