Xos, Xos, Xos, Xos, Xos^Efs, Xos, Xos, Xos, Xos^Efs, Xos, Xos, Xos, Xos
Xos, Xos, Xos, Xos, Ur, Ur, Ur, Ur, Ur, Xos, Xos, Xos, Xos
Xos, Xos, Xos, Qlf, Ur, Ur, Ur, Ur, Ur, Qlf, Xos, Xos, Xos
Xos, Xos, Ur, Ur, Ur, Ur, Ur, Ur, Ur, Ur, Ur, Xos, Xos
Xos, Xos, Ur, Xos^Efs, Ur, Ur, Ur, Ur, Ur, Xos^Efs, Ur, Xos, Xos
Xos, Qlf, Ur, Ur, Ur, Ur, Ur, Ur, Ur, Ur, Ur, Qlf, Xos
Xos, Qlf, Ur, Xos^Efs, Ur, Ur, Ur, Ur, Ur, Xos^Efs, Ur, Qlf, Xos
Xos, Xos, Ur, Ur, Ur, Ur, Ur, Ur, Ur, Ur, Ur, Xos, Xos
Xos, Xos, Ur, Xos^Efs, Ur, Ur, Ur, Ur, Ur, Xos^Efs, Ur, Xos, Xos
Xos, Xos, Xos, Ur, Ur, Ur, Ur^Ii, Ur, Ur, Ur, Xos, Xos, Xos
Xos, Xos, Xos, Xos, Xos, Ur^Ii, 1 Ur^Ii, Ur^Ii, Xos, Xos, Xos, Xos, Xos
Xos, Xos, Xos, Xos, Xos, Xos, Xos, Xos, Xos, Xos, Xos, Xos, Xos
