Xu, Xu, Xu, Xu, Xu, Xu, Xoa, Xu, Xu, Xu, Xu, Xu, Xu
Xu, Xu, Xu, Xu, Xoa, Xoa, Urb, Xoa, Xoa, Xu, Qxua, Xu, Xu
Xu, Xu, Xu, Xu, Xoa, Urb, Urb, Urb, Xoa, Xu, Qxua, Qxua, Xu
Xu, Xu, Xu, Xu, Xoa^Efs, Urb, Urb, Urb, Xoa^Efs, Xu, Qxua, Qxua, Xu
Xu, Xu, Urb, Urb, Urb, Urb, Urb, Urb, Urb, Urb, Urb, Qxua, Xu
Xu, Xu, Urb, Xoa^Efs, Urb, Urb, Urb, Urb, Urb, Xoa^Efs, Urb, Urb, Xu
Xu, Xu, Urb, Urb, Urb, Urb, Urb, Urb, Urb, Urb, Urb, Xu, Xu
Xu, Xu, Urb, Urb, Urb, Urb, Urb, Urb, Urb, Urb, Urb, Xu, Xu
Xu, Xu, Urb, Xoa^Efs, Urb, Urb, Urb, Urb, Urb, Xoa^Efs, Urb, Xu, Xu
Xu, Xu, Xu, Urb, Urb, Urb, Urb^Ii, Urb, Urb, Urb, Xu, Xu, Xu
Xu, Xu, Xu, Xu, Xu, Urb^Ii, 1 Urb^Ii, Urb^Ii, Xu, Xu, Xu, Xu, Xu
Xu, Xu, Xu, Xu, Xu, Xu, Xu, Xu, Xu, Xu, Xu, Xu, Xu
