Xoa, Xoa, Xoa, Xoa, Xoa, Xos, Xoa, Xoa, Xoa, Xoa, Xoa, Xoa, Xoa
Xoa, Xoa, Xoa, Xoa, Xoa, Xoa, Urb, Xoa, Xoa, Xoa, Xoa, Xoa, Xoa
Xoa, Xoa, Xoa, Xoa, Qxua, Urb, Urb, Urb, Qxua, Xoa, Xoa, Xoa, Xoa
Xoa, Xoa, Qxua, Qxua, Qxua, Urb, Urb, Urb, Qxua, Qxua, Qxua, Xoa, Xoa
Xoa, Xoa, Qxua, Qxua, Urb, Urb, Urb, Urb, Urb, Qxua, Qxua, Xoa, Xoa
Xu, Xoa, Qxua, Urb, Urb, Urb, Urb, Urb, Urb, Urb, Qxua, Xoa, Xoa
Xu, Xoa, Qxua, Urb, Urb, Urb, Urb, Urb, Urb, Urb, Qxua, Xoa, Xoa
Xu, Xoa, Qxua, Qxua, Qxua, Urb, Urb, Urb, Qxua, Qxua, Qxua, Xoa, Xoa
Xoa, Xoa, Qxua, Qxua, Qxua, Urb, Urb, Urb, Qxua, Qxua, Qxua, Xoa, Xoa
Xoa, Xoa, Xoa, Qxua, Qxua, Urb, Urb^Ii, Urb, Qxua, Qxua, Xoa, Xoa, Xoa
Xoa, Xoa, Xoa, Xoa, Xoa, Urb^Ii, 1 Urb^Ii, Urb^Ii, Xoa, Xoa, Xoa, Xoa, Xoa
Xoa, Xoa, Xoa, Xoa, Xoa, Xoa, Xoa, Xoa, Xoa, Xoa, Xoa, Xoa, Xoa
