Xu, Xu, Xu, Xu, Xu, Xu, Xu, Xu, Xu, Xu, Xu, Xu, Xu
Xu, Xu, Xu, Xu, Ds, Uu, Ds, Uu, Ds, Xu, Xu, Xu, Xu
Xu, Xu, Ww, Ds, Ds, Ds, Ds, Ds, Ds, Ds, Ww, Xu, Xu
Xu, Ww, Ds, Ds, Wwf, Wwf, Ww, Wwf, Wwf, Ds, Ds, Ww, Xu
Xu, Ww, Ds, Wwf, Ww, Ww, Wog^Ewl, Ww, Ww, Wwf, Ds, Ww, Xu
Xu, Xu, Ds, Wwf, Ww, Wog^Ewl, Qxu^Ii, Wog^Ewl, Ww, Wwf, Ds, Xu, Xu
Xu, Xu, Ds, Wwf, Ww, Wog^Ewl, Wog^Ewl, Wog^Ewl, Ww, Wwf, Ds, Xu, Xu
Xu, Ww, Ds, Wwf, Wwf, Ww, Ww, Ww, Wwf, Wwf, Ds, Ww, Xu
Xu, Ww, Ww, Ds, Ds, Wwf, Wwf, Wwf, Ds, Ds, Ww, Ww, Xu
Xu, Xu, Xu, Ds, Ds, Ds, Ds^Ii, Ds, Ds, Ds, Xu, Xu, Xu
Xu, Xu, Xu, Xu, Xu, Ur^Ii, 1 Ur^Ii, Ur^Ii, Xu, Xu, Xu, Xu, Xu
Xu, Xu, Xu, Xu, Xu, Xu, Xu, Xu, Xu, Xu, Xu, Xu, Xu
