Xu, Xu, Xu, Xu, Xu, Xu, Xu, Xu, Xu, Xu, Xu, Xu, Xu
Xu, Xu, Xu, Xu, Xu, Xu, Rd, Ds, Ss, Xu, Xu, Xu, Xu
Xu, Xu, Xu, Xu, Rd, Rd, Ds, Ds, Ss, Ss, Ww, Xu, Wo
Xu, Xu, Ds, Rd, Ds, Ds, Wwf, Ds, Ww, Ww, Wo, Wo, Wo
Xu, Xu, Ss, Ds, Ds, Wwf, Wwf, Ww, Ww, Ww, Wo, Wo, Wo
Xu, Xu, Ss, Ds, Ww, Wwf, Wwf, Wwf, Ss, Ww, Ww, Wo, Xu
Xu, Xu, Ss, Ds, Ww, Wwf, Wwf, Wwf, Ds, Ss, Ss, Xu, Xu
Xu, Xu, Ss, Ss, Ww, Ww, Wwf, Wwf, Ds, Ds, Ds, Xu, Xu
Wo, Wo, Wo, Ww, Ww, Ss, Ds, Ds, Rd, Rd, Rd, Xu, Xu
Wo, Wo, Wo, Ww, Ss, Ss, Ur^Ii, Rd, Rd, Rd, Xu, Xu, Xu
Wo, Wo, Xu, Xu, Xu, Ur^Ii, 1 Ur^Ii, Ur^Ii, Xu, Xu, Xu, Xu, Xu
Xu, Xu, Xu, Xu, Xoa, Xu, Xu, Xu, Xu, Xu, Xu, Xu, Xu
