Xu, Xu, Xu, Xu, Xu, Xu, Xoc, Xu, Xu, Xu, Xu, Xu, Xu
Xu, Xu, Xu, Xu, Xoc, Xoc, Isr, Xoc, Xoc, Xu, Uu, Xu, Xu
Xu, Xu, Xu, Xu, Xoc, Isr, Isr, Isr, Xoc, Xu, Uu, Xu, Xu
Xu, Xu, Xu, Xu, Xoc^Efs, Isr, Isr, Isr, Xoc^Efs, Xu, Uu, Xu, Xu
Xu, Xu, Ur, Ur, Ur, Isa, Isa, Isa, Ur, Uu, Uu, Xu, Xu
Xu, Xu, Ur, Xos^Efs, Ur, Isa, Isa, Isa, Ur, Xos^Efs, Ur, Xu, Xu
Xu, Xu, Ur, Ur, Ur, Isa, Isa, Isa, Ur, Ur, Ur, Xu, Xu
Xu, Xu, Ur, Ur, Ur, Isa, Isa, Isa, Ur, Ur, Ur, Xu, Xu
Xu, Xu, Ur, Xos^Efs, Ur, Isa, Isa, Isa, Ur, Xos^Efs, Ur, Xu, Xu
Xu, Xu, Xu, Ur, Ur, Isa, Isa^Ii, Isa, Ur, Ur, Xu, Xu, Xu
Xu, Xu, Xu, Xu, Xu, Isa^Ii, 1 Isa^Ii, Isa^Ii, Xu, Xu, Xu, Xu, Xu
Xu, Xu, Xu, Xu, Xu, Xu, Xu, Xu, Xu, Xu, Xu, Xu, Xu
