Xu, Xu, Xu, Xu, Xu, Xu, Xu, Xu, Xu, Xu, Xu, Xu, Xu
Xu, Xu, Xu, Xu, Xu, Xu, Rr, Xu, Xu, Xu, Xu, Xu, Xu
Xu, Xu, Xu, Xu, Ur, Rr, Rr, Rr, Ur, Xu, Xu, Xu, Xu
Xu, Xu, Ur, Ur, Ur, Rr, Rr, Rr, Ur, Ur, Ur, Xu, Xu
Xu, Xu, Ur, Ur, Ur, Ur, Ur, Ur, Ur, Ur, Ur, Xu, Xu
Xu, Xu, Ur, Ur, Ur, Ur, Ur, Ur, Ur, Ur, Ur, Xu, Xu
Xu, Xu, Ur, Ur, Ur, Ur, Ur, Ur, Ur, Ur, Ur, Xu, Xu
Xu, Xu, Ur, Ur, Ur, Ur, Ur, Ur, Ur, Ur, Ur, Xu, Xu
Xu, Xu, Ur, Ur, Ur, Ur, Ur, Ur, Ur, Ur, Ur, Xu, Xu
Xu, Xu, Xu, Ur, Ur, Ur, Ur^Ii, Ur, Ur, Ur, Xu, Xu, Xu
Xu, Xu, Xu, Xu, Xu, 1 Ur^Ii, Ur^Ii, 2 Ur^Ii, Xu, Xu, Xu, Xu, Xu
Xu, Xu, Xu, Xu, Xu, Xu, Xu, Xu, Xu, Xu, Xu, Xu, Xu
