Qxua, Qxua, Qxua, Qxua, Qxua, Qxua, Qxua, Qxua, Qxua, Qxua, Qxua, Qxua, Qxua
Qxua, Qxua, Qxua, Qxua, Xu, Qxua, Ur, Qxua, Xu, Qxua, Qxua, Qxua, Qxua
Qxua, Qxua, Qxua, Xu, Uu, Ur, Ur, Ur, Uu, Xu, Qxua, Qxua, Qxua
Qxua, Qxua, Uu, Uu, Uu, Ur, Ur, Ur, Uu, Uu, Uu, Qxua, Qxua
Qxua, Uh, Uu, Xu, Xu, Uu, Uu, Uu, Xu, Xu, Uu, Uh, Qxua
Qxua, Qxua, Uu, Xu, Uu, Uu, Qxua, Uu, Uu, Xu, Uu, Qxua, Qxua
Qxua, Qxua, Uu, Uu, Xu, Uu, Qxua, Uu, Xu, Uu, Uu, Qxua, Qxua
Qxua, Qxua, Uh, Uu, Uu, Uu, Uu, Uu, Uu, Uu, Uh, Qxua, Qxua
Qxua, Qxua, Qxua, Qxua, Uu, Uu, Uu, Uu, Uu, Qxua, Qxua, Qxua, Qxua
Qxua, Qxua, Uh, Uu, Uu, Uu, Ur^Ii, Uu, Uu, Uu, Uh, Qxua, Qxua
Qxua, Qxua, Qxua, Uu, Qxua, Ur^Ii, 1 Ur^Ii, Ur^Ii, Qxua, Uu, Qxua, Qxua, Qxua
Qxua, Qxua, Qxua, Qxua, Qxua, Qxua, Qxua, Qxua, Qxua, Qxua, Qxua, Qxua, Qxua
