Xu, Xu, Xu, Xu, Xu, Xu, Xu, Xu, Xu, Xu, Xu, Xu, Xu
Xu, Xu, Xu, Xu, Xu, Xu, Rr, Xu, Xu, Xu, Xu, Xu, Xu
Xu, Xu, Xu, Xu, Ur, Rr, Rr, Rr, Ur, Xu, Xu, Xu, Xu
Xu, Xu, Ur, Ur, Ur, Rr, Rr, Rr, Ur, Ur, Ur, Xu, Xu
Xu, Xu, Ds, Ds, Ds, Ds, Ds, Ds, Ds, Ds, Ds, Xu, Xu
Wo, Xu, Ww, Wwg, Wwg, Wwf, Wwf, Wwf, Wwg, Wwg, Ww, Xu, Wo
Wo, Wo, Wo, Wog, Ww, Wwf, Wwf, Wwf, Ww, Wog, Wog, Wo, Wo
Wo, Wo, Ww, Wog, Wwg, Wwf, Wwf, Wwf, Wwg, Wog, Ww, Wo, Wo
Xu, Xu, Ds, Wwg, Ds, Wwf, Ds, Wwf, Ds, Wwg, Ds, Xu, Xu
Xu, Xu, Xu, Ds, Ur, Ds, Ur^Ii, Ds, Ur, Ds, Xu, Xu, Xu
Xu, Xu, Xu, Xu, Xu, Ur^Ii, 1 Ur^Ii, Ur^Ii, Xu, Xu, Xu, Xu, Xu
Xu, Xu, Xu, Xu, Xu, Xu, Xu, Xu, Xu, Xu, Xu, Xu, Xu
