Xue, Xue, Xue, Xue, Xue, Xue, Xue, Xue, Xue, Xue, Xue, Xue, Xue
Xue, Xue, Xue, Xue, Xue, Xue, Rp, Xue, Xue, Xue, Xue, Xue, Xue
Xue, Xue, Xue, Xue, Gs, Rp, Rp, Rp, Gs, Xue, Xue, Xue, Xue
Xue, Xue, Gll^Ftr, Gll^Ftr, Gs, Rp, Rp, Rp, Gs, Gll^Ftr, Gll^Ftr, Xue, Xue
Xue, Xue, Gll^Ftr, Gs, Gll^Ftr, Gs, Gs, Gs, Gll^Ftr, Gs, Gll^Ftr, Xue, Xue
Xue, Xue, Gs, Gs, Gll^Ftr, Gll^Ftr, Gs, Gll^Ftr, Gll^Ftr, Gs, Gs, Xue, Xue
Xue, Xue, Gs, Gs, Gs, Gll^Ftr, Gs, Gll^Ftr, Gs, Gs, Gs, Xue, Xue
Xue, Xue, Gll^Ftr, Gs, Gll^Ftr, Gs, Gs, Gs, Gll^Ftr, Gs, Gll^Ftr, Xue, Xue
Xue, Xue, Gll^Ftr, Gs, Gs, Gs, Gs, Gs, Gs, Gs, Gll^Ftr, Xue, Xue
Xue, Xue, Xue, Gll^Ftr, Gs, Gs, Rp^Ii, Gs, Gs, Gll^Ftr, Xue, Xue, Xue
Xue, Xue, Xue, Xue, Xue, Rp^Ii, 1 Rp^Ii, Rp^Ii, Xue, Xue, Xue, Xue, Xue
Xue, Xue, Xue, Xue, Xue, Xue, Xue, Xue, Xue, Xue, Xue, Xue, Xue
