Xoc, Xoc, Xoc, Xoc, Xoc, Xoc, Xoc, Xoc, Xoc, Xoc, Xoc, Xoc, Xoc
Xoc, Xoc, Xoc, Xoc, Xoc, Xoc, Irs, Xoc, Xoc, Xoc, Xoc, Xoc, Xoc
Xoc, Xoc, Xoc, Xoc, Irs^Efm, Irs, Ql, Irs, Irs^Efm, Xoc, Xoc, Xoc, Xoc
Xoc, Xoc, Irs, Irs^Efm, Ql, Irs, Irs, Irs, Ql, Irs^Efm, Irs, Xoc, Xoc
Xoc, Xoc, Aa^Feta, Irs, Irs, Irs, Qxua^Efm, Irs, Irs, Irs, Aa^Feta, Xoc, Xoc
Xoc, Xoc, Irs, Irs, Qxua^Efm, Qxua^Efm, Qxua^Efm, Qxua^Efm, Qxua^Efm, Irs, Irs, Xoc, Xoc
Xoc, Xoc, Aa^Feta, Irs, Irs, Qxua^Efm, Qxua^Efm, Qxua^Efm, Irs, Irs, Aa^Feta, Xoc, Xoc
Xoc, Xoc, Irs, Irs, Ql, Irs, Irs, Irs, Ql, Irs, Irs, Xoc, Xoc
Xoc, Xoc, Irs, Irs, Irs, Irs, Ql, Irs, Irs, Irs, Irs, Xoc, Xoc
Xoc, Xoc, Xoc, Irs, Irs^Efm, Irs, Irs^Ii, Irs, Irs^Efm, Irs, Xoc, Xoc, Xoc
Xoc, Xoc, Xoc, Xoc, Xoc, Irs^Ii, 1 Irs^Ii, Irs^Ii, Xoc, Xoc, Xoc, Xoc, Xoc
Xoc, Xoc, Xoc, Xoc, Xoc, Irs^Ii, Irs^Ii, Irs^Ii, Xoc, Xoc, Xoc, Xoc, Xoc
