Qxua, Qxua, Qxua, Qxua, Qxua, Qxua, Qxua, Qxua, Qxua, Qxua, Qxua, Qxua, Qxua
Qxua, Qxua, Qxua, Qxua, Qxua, Qxua, Rr, Qxua, Qxua, Qxua, Qxua, Qxua, Qxua
Qxua, Qxua, Qxua, Qxua, Ur, Rr, Rr, Rr, Ur, Qxua, Qxua, Qxua, Qxua
Qxua, Qxua, Ur, Ur, Rb^Fdw, Rr, Rr, Rr, Rb^Fdw, Ur, Ur, Qxua, Qxua
Qxua, Qxua, Ur, Rb^Fdw, Rb, Rb, Qxua, Rb, Rb, Rb^Fdw, Ur, Qxua, Qxua
Qxua, Qxua, Ur, Rb^Fetd, Rb, Qxua, Qxua, Qxua, Rb, Rb^Fetd, Ur, Qxua, Qxua
Qxua, Qxua, Ur, Rb^Fdw, Rb, Qxua, Qxua, Qxua, Rb, Rb^Fdw, Ur, Qxua, Qxua
Qxua, Qxua, Ur, Rb^Fdw, Rb, Qxua, Qxua, Qxua, Rb, Rb^Fdw, Ur, Qxua, Qxua
Qxua, Qxua, Ur, Rb^Fetd, Rb, Rb, Rb, Rb, Rb, Rb^Fetd, Ur, Qxua, Qxua
Qxua, Qxua, Qxua, Ur, Ur, Rb, Ur^Ii, Rb, Ur, Ur, Qxua, Qxua, Qxua
Qxua, Qxua, Qxua, Qxua, Qxua, Ur^Ii, 1 Ur^Ii, Ur^Ii, Qxua, Qxua, Qxua, Qxua, Qxua
Qxua, Qxua, Qxua, Qxua, Qxua, Qxua, Qxua, Qxua, Qxua, Qxua, Qxua, Qxua, Qxua
