Xu, Xu, Xu, Xu, Xu, Xu, Xu, Xu, Xu, Xu, Xu, Xu, Xu
Xu, Xu, Xu, Xu, Xu, Xu, Uu^Wybs, Xu, Xu, Xu, Xu, Xu, Xu
Xu, Xu, Xu, Xu, Ur, Ur, Ur, Ur, Ur, Xu, Xu, Xu, Xu
Xu, Xu, Ur, Ur, Ur, Ur, Xu, Ur, Ur, Ur, Ur, Xu, Xu
Xu, Xu, Ur, Ur, Xu, Xu, Uu^Wybs, Xu, Xu, Ur, Ur, Xu, Xu
Xu, Xu, Ur, Uu^Wybs, Xu, Ur, Ur, Ur, Xu, Uu^Wybs, Ur, Xu, Xu
Xu, Xu, Ur, Xu, Xu, Uu^Wybs, Ur, Uu^Wybs, Xu, Xu, Ur, Xu, Xu
Xu, Xu, Ur, Ur, Ur, Xu, Ur, Xu, Ur, Ur, Ur, Xu, Xu
Xu, Xu, Uu^Wybs, Ur, Ur, Ur, Ur, Ur, Ur, Ur, Uu^Wybs, Xu, Xu
Xu, Xu, Xu, Ur, Ur, Ur, Ur^Ii, Ur, Ur, Ur, Xu, Xu, Xu
Xu, Xu, Xu, Xu, Xu, Ur^Ii, 1 Ur^Ii, Ur^Ii, Xu, Xu, Xu, Xu, Xu
Xu, Xu, Xu, Xu, Xu, Xu, Xu, Xu, Xu, Xu, Xu, Xu, Xu
