border_size=1
usage=map

Xos, Xos, Xos, Xos, Xos^Efs, Xos, Xos, Xos, Xos^Efs, Xos, Xos, Xos, Xos
Xos, Xos, Xos, Xos^Efs, Urb, Urb, Urb, Urb, Urb, Xos^Efs, Xos, Xos, Xos
Xos, Xos, Urb, Xos, Xos^Efs, Urb, Urb, Urb, Xos^Efs, Urb, Urb, Xos, Xos
Xos, Xos, Urb, Urb, Urb, Xos^Efs, Xos, Xos^Efs, Urb, Urb, Urb, Xos, Xos
Xos, Xos, Urb, Xos, Xos^Efs, Urb, Urb, Urb, Xos^Efs, Xos, Urb, Xos, Xos
Xos, Xos, Urb, Urb, Xos, Xos, Xos^Efs, Urb, Xos, Urb, Urb, Xos, Xos
Xos, Xos, Xos, Urb, Urb, Urb, Urb, Xos^Efs, Urb, Xos, Xos, Xos, Xos
Xos, Xos, Urb, Urb, Xos, Urb, Urb, Urb, Xos^Efs, Urb, Urb, Xos, Xos
Xos, Xos, Urb, Urb, Urb, Xos, Xos, Xos^Efs, Urb, Urb, Urb, Xos, Xos
Xos, Xos, Xos, Urb, Xos, Xos, Ur^Ii, Urb, Urb, Urb, Xos, Xos, Xos
Xos, Xos, Xos, Xos, Xos, Ur^Ii, 1 Ur^Ii, Ur^Ii, Xos, Xos, Xos, Xos, Xos
Xos, Xos, Xos, Xos, Xos, Xos, Xos, Xos, Xos, Xos, Xos, Xos, Xos
