Xos, Xos, Xos, Xos, Xos^Efs, Xos, Xos, Xos, Xos^Efs, Xos, Xos, Xos, Xos
Xos, Xos, Xos, Xos^Efs, Urb, Urb, Urb, Urb, Urb, Xos, Xos, Xos, Xos
Xos, Xos, Urb, Xot, Xos, Urb, Urb, Urb, Xos, Urb, Urb, Xos, Xos
Xos, Xos, Urb, Urb, Urb, Xos, Xos, Xos, Urb, Urb, Urb, Xos, Xos
Xos, Xos, Urb, Xos, Xos^Efs, Urb, Urb, Urb, Xot, Xos, Urb, Xos, Xos
Xos, Xos, Urb, Urb, Xos, Xot, Xos, Urb, Xos, Urb, Urb, Xos, Xos
Xos, Xos, Xos, Urb, Urb, Urb, Urb, Xos, Urb, Xos, Xos, Xos, Xos
Xos, Xos, Urb, Urb, Xos, Urb, Urb, Urb, Xos, Urb, Urb, Xos, Xos
Xos, Xos, Urb, Urb, Urb, Xos, Xos, Xos, Urb, Urb, Urb, Xos, Xos
Xos, Xos, Xos, Urb, Xos, Xos, Ur^Ii, Urb, Urb, Urb, Xos, Xos, Xos
Xos, Xos, Xos, Xos, Xos, Ur^Ii, 1 Ur^Ii, Ur^Ii, Xos, Xos, Xos, Xos, Xos
Xos, Xos, Xos, Xos, Xos, Xos, Xos, Xos, Xos, Xos, Xos, Xos, Xos
