Xof, Xof, Xof, Xof, Xof, Xof, Xof, Xof, Xof, Xof, Xof, Xof, Xof
Xof, Xof, Xof, Xof, Gs, Rp, Rp, Rp, Gs, Xof, Xof, Xof, Xof
Xof, Xof, Gll^Ftr, Gs, Xof, Rp, Rp, Rp, Xof, Gs, Gll^Ftr, Xof, Xof
Xof, Gll^Ftr, Gs, Gs, Gs, Gs, Rp, Gs, Gs, Gs, Gs, Gll^Ftr, Xof
Xof, Gll^Ftr, Gs, Gs, Gll^Ftr, Gs, Rp, Gs, Gll^Ftr, Gs, Gs, Gll^Ftr, Xof
Xof, Gs, Xof, Gs, Gll^Ftr, Gs, Rp, Gs, Gll^Ftr, Gs, Xof, Gs, Xof
Xof, Gs, Gs, Gs, Gll^Ftr, Gs, Rp, Gs, Gll^Ftr, Gs, Gs, Gs, Xof
Xof, Gll^Ftr, Gs, Gs, Gs, Gs, Rp, Gs, Gs, Gs, Gs, Gll^Ftr, Xof
Xof, Gll^Ftr, Gll^Ftr, Gs, Gs, Gs, Rp, Gs, Gs, Gs, Gll^Ftr, Gll^Ftr, Xof
Xof, Xof, Xof, Gs, Gs, Gs, Rp^Ii, Gs, Gs, Gs, Xof, Xof, Xof
Xof, Xof, Xof, Xof, Xof, Rp^Ii, 1 Rp^Ii, Rp^Ii, Xof, Xof, Xof, Xof, Xof
Xof, Xof, Xof, Xof, Xof, Xof, Xof, Xof, Xof, Xof, Xof, Xof, Xof
