Xue, Xue, Xue, Xue, Xue, Xue, Xue, Xue, Xue, Xue, Xue, Xue, Xue
Xue, Xue, Xue, Xue, Xue, Xue, Rp, Xue, Xue, Xue, Xue, Xue, Xue
Xue, Xue, Xue, Xue, Gll^Ftr, Rp, Rp, Rp, Ss, Xue, Xue, Xue, Xue
Xue, Xue, Gll^Ftr, Gll^Ftr, Gs, Rp, Rp, Rp, Ss, Gll^Ftr, Gll^Ftr, Xue, Xue
Xue, Xue, Gll^Ftr, Gs, Re, Re, Gs, Ss, Gll^Ftr, Gll^Ftr, Gll^Ftr, Xue, Xue
Xue, Xue, Gll^Ftr, Gs, Re, Gs, Gll^Ftr, Gll^Ftr, Re, Ss, Gll^Ftr, Xue, Xue
Xue, Xue, Gll^Ftr, Gs, Re, Gll^Ftr, Re, Re, Gs, Re, Gll^Ftr, Xue, Xue
Xue, Xue, Gll^Ftr, Gs, Gs, Re, Gs, Gs, Gs, Re, Gll^Ftr, Xue, Xue
Xue, Xue, Gll^Ftr, Ss, Ss, Gs, Gll^Ftr, Gll^Ftr, Gs, Re, Gll^Ftr, Xue, Xue
Xue, Xue, Xue, Gll^Ftr, Gll^Ftr, Gll^Ftr, Rp^Ii, Gs, Re, Re, Xue, Xue, Xue
Xue, Xue, Xue, Xue, Xue, Rp^Ii, 1 Rp^Ii, Rp^Ii, Xue, Xue, Xue, Xue, Xue
Xue, Xue, Xue, Xue, Xue, Xue, Xue, Xue, Xue, Xue, Xue, Xue, Xue
