Xu, Xu, Xu, Xu, Xu, Xu, Xu, Xu, Xu, Xu, Xu, Xu, Xu
Xu, Xu, Xu, Xu, Ds, Uu, Uu, Uu, Ds, Xu, Xu, Xu, Xu
Xu, Xu, Ww, Ds, Ww, Ds, Ds, Ds, Wwf, Qxu, Qxu, Xu, Xu
Ww, Ww, Wog, Ww, Ww, Ww, Ww, Wwf, Wwf, Wwf, Qxu, Xu, Xu
Wog, Wog, Wog, Wog, Wog, Ww, Ww, Ww, Wwf, Wwf, Qxu, Xu, Xu
Wog, Wog^Ewl, Wog^Ewl, Wog^Ewl, Wog, Wog, Ww, Ww, Wwf, Wwf, Qxu, Xu, Xu
Wog, Wog^Ewl, Wog, Wog^Ewf, Wog, Wog, Ww, Ww, Wwf, Wwf, Qxu, Xu, Xu
Ww, Wog, Wog, Wog, Ww, Ww, Ww, Ww, Wwf, Wwf, Qxu, Xu, Xu
Xu, Ww, Ww, Ww, Ds, Ww, Ds, Wwf, Wwf, Wwf, Qxu, Xu, Xu
Xu, Xu, Xu, Ds, Ds, Ds, Ur^Ii, Ds, Ds, Qxu, Xu, Xu, Xu
Xu, Xu, Xu, Xu, Xu, Ur^Ii, 1 Ur^Ii, Ur^Ii, Xu, Xu, Xu, Xu, Xu
Xu, Xu, Xu, Xu, Xu, Xu, Xu, Xu, Xu, Xu, Xu, Xu, Xu
