Xos, Xos, Xos, Xos, Xos^Efs, Xos, Xos, Xos, Xos^Efs, Xos, Xos, Xos, Xos
Xos, Xos, Xos, Xos^Efs, Urb, Urb, Urb, Urb, Urb, Xos^Efs, Xos, Xos, Xos
Xos, Xos, Xos, Xos, Xos, Urb, Urb, Urb, Xos, Xos, Xos, Xos, Xos
Xos, Xos, Urb, Urb, Urb, Xos, Urb, Xos, Urb, Urb, Urb, Xos, Xos
Xos, Xos, Urb, Urb^Por, Urb, Xos, Urb, Xos, Urb, Urb^Pob, Urb, Xos, Xos
Xos, Xos, Urb, Urb, Urb, Xos, Urb, Xos, Urb, Urb, Urb, Xos, Xos
Xos, Xos, Xos, Urb, Xos, Urb, Urb, Urb, Xos, Urb, Xos, Xos, Xos
Xos, Xos, Xos, Xos, Urb, Xos, Xos, Xos, Urb, Xos, Xos, Xos, Xos
Xos, Xos, Xos, Urb, Urb^Pob, Urb, Xos, Urb, Urb^Por, Urb, Xos, Xos, Xos
Xos, Xos, Xos, Urb, Urb, Urb, Ur^Ii, Urb, Urb, Urb, Xos, Xos, Xos
Xos, Xos, Xos, Xos, Xos, Ur^Ii, 1 Ur^Ii, Ur^Ii, Xos, Xos, Xos, Xos, Xos
Xos, Xos, Xos, Xos, Xos, Xos, Xos, Xos, Xos, Xos, Xos, Xos, Xos
