Qxua, Qxua, Qxua, Qxua, Qxua, Qxua, Qxua, Qxua, Qxua, Qxua, Qxua, Qxua, Qxua
Qxua, Qxua, Qxua, Qxua, Qxua, Qxua, Rr, Qxua, Qxua, Qxua, Qxua, Qxua, Qxua
Qxua, Qxua, Qxua, Qxua, Ur, Rr, Rr, Rr, Ur, Qxua, Qxua, Qxua, Qxua
Qxua, Qxua, Ur, Ur, Ur, Rr, Rr, Rr, Ur, Ur, Ur, Qxua, Qxua
Qxua, Qxua, Ur, Ur^Xbl, Ur, Ur^Xbl, Ur^Xbl, Ur^Xbl, Ur, Ur^Xbl, Ur, Qxua, Qxua
Qxua, Qxua, Ur, Ur, Ur, Ur, Ur, Ur, Ur, Ur, Ur, Qxua, Qxua
Qxua, Qxua, Ur, Ur^Xbl, Ur, Ur, Ur^Xbl, Ur, Ur, Ur^Xbl, Ur, Qxua, Qxua
Qxua, Qxua, Ur, Ur, Ur, Ur^Xbl, Ur^Xbl, Ur^Xbl, Ur, Ur, Ur, Qxua, Qxua
Qxua, Qxua, Ur, Ur^Xbl, Ur, Ur, Ur^Xbl, Ur, Ur, Ur^Xbl, Ur, Qxua, Qxua
Qxua, Qxua, Qxua, Ur, Ur, Ur, Ur^Ii, Ur, Ur, Ur, Qxua, Qxua, Qxua
Qxua, Qxua, Qxua, Qxua, Qxua, Ur^Ii, 1 Ur^Ii, Ur^Ii, Qxua, Qxua, Qxua, Qxua, Qxua
Qxua, Qxua, Qxua, Qxua, Qxua, Qxua, Qxua, Qxua, Qxua, Qxua, Qxua, Qxua, Qxua
