Qxua, Qxua, Qxua, Qxua, Qxua, Qxua, Qxua, Qxua, Qxua, Qxua, Qxua, Qxua, Qxua
Qxua, Qxua, Qxua, Qxua, Qxua, Qxua, Rr, Qxua, Qxua, Qxua, Qxua, Qxua, Qxua
Qxua, Qxua, Qxua, Qxua, Qxua^Bsb/, Rr, Rr, Rr, Qxua^Bsb\, Qxua, Qxua, Qxua, Qxua
Qxua, Qxua, Qxua^Bsb/, Qxua^Bsb/, Qxua, Rr, Rr, Rr, Qxua, Qxua^Bsb\, Qxua^Bsb\, Qxua, Qxua
Qxua, Ur, Ur, Qxua, Qxua, Qxua, Qxua, Qxua, Qxua, Qxua, Ur, Ur, Qxua
Qxua, Ur, Qxua, Qxua^Bsb\, Qxua^Bsb\, Qxua, Xoa, Qxua, Qxua^Bsb/, Qxua^Bsb/, Qxua, Ur, Qxua
Qxua, Qxua, Qxua, Qxua, Ur, Ur, Xoa, Ur, Ur, Qxua, Qxua, Qxua, Qxua
Qxua, Qxua, Xoa^Efs, Qxua, Qxua, Ur^Pob, Xoa^Efs, Ur^Por, Qxua, Qxua, Xoa^Efs, Qxua, Qxua
Qxua, Xoa, Ur, Xoa, Qxua, Qxua, Qxua, Qxua, Qxua, Xoa, Ur, Xoa, Qxua
Qxua, Ur^Pob, Ur, Qxua^Bsb\, Qxua^Bsb\, Qxua, Ur^Ii, Qxua, Qxua^Bsb/, Qxua^Bsb/, Ur, Ur^Por, Qxua
Qxua, Ur, Qxua, Qxua, Qxua, Ur^Ii, 1 Ur^Ii, Ur^Ii, Qxua, Qxua, Qxua, Ur, Qxua
Qxua, Qxua, Qxua, Qxua, Qxua, Qxua, Qxua, Qxua, Qxua, Qxua, Qxua, Qxua, Qxua
