Xue, Xue, Xue, Xue, Xue, Xue, Xue, Xue, Xue, Xue, Xue, Xue, Xue
Xue, Xue, Xue, Xue, Xue, Xue, Rp, Xue, Xue, Xue, Xue, Xue, Xue
Xue, Xue, Xue, Xue, Gll^Ftr, Rp, Rp, Rp, Gll^Ftr, Xue, Xue, Xue, Xue
Xue, Xue, Gll^Ftr, Gll^Ftr, Re, Rp, Rp, Rp, Re, Gll^Ftr, Gll^Ftr, Xue, Xue
Xue, Xue, Gs, Re, Gs^Ft, Gs^Ft, Wwt, Gs^Ft, Gs^Ft, Re, Gs, Xue, Xue
Xue, Xue, Gs, Re, Gs^Ft, Wwt, Wot, Wwt, Gs^Ft, Re, Gs, Xue, Xue
Xue, Xue, Gs, Re, Gs^Ft, Wwt, Wot, Wwt, Gs^Ft, Re, Gs, Xue, Xue
Xue, Xue, Gs, Re, Gs^Ft, Wwt, Wwt, Wwt, Gs^Ft, Re, Gs, Xue, Xue
Xue, Xue, Gll^Ftr, Re, Re, Gs, Gs, Gs, Re, Re, Gll^Ftr, Xue, Xue
Xue, Xue, Xue, Gs, Gs, Re, Rp^Ii, Re, Gs, Gs, Xue, Xue, Xue
Xue, Xue, Xue, Xue, Xue, Rp^Ii, 1 Rp^Ii, Rp^Ii, Xue, Xue, Xue, Xue, Xue
Xue, Xue, Xue, Xue, Xue, Xue, Xue, Xue, Xue, Xue, Xue, Xue, Xue
