Xoav, Xoav, Xoav, Xoav, Xoav, Xoav, Xoav, Xoav, Xoav, Xoav, Xoav, Xoav, Xoav
Xoav, Xoav, Xoav, Xoav, Xoav, Xoav, Yhl, Xoav, Xoav, Xoav, Xoav, Xoav, Xoav
Xoav, Xoav, Xoav, Xoav, Qxvi, Yhl, Yhl, Yhl, Qxvi, Xoav, Xoav, Xoav, Xoav
Xoav, Xoav, Qxvi, Qxvi, Qxvi, Yhl, Yhl, Yhl, Qxvi, Qxvi, Qxvi, Xoav, Xoav
Xoav, Xoav, Qxvi, Qxvi, Yhl, Yhl, Yhl, Yhl, Yhl, Qxvi, Qxvi, Xoav, Xoav
Xoav, Xoav, Qxvi, Yhl, Yhl, Yhl, Yhl, Yhl, Yhl, Yhl, Qxvi, Xoav, Xoav
Xoav, Xoav, Qxvi, Yhl, Yhl, Yhl, Yhl, Yhl, Yhl, Yhl, Qxvi, Xoav, Xoav
Xoav, Xoav, Qxvi, Qxvi, Qxvi, Yhl, Yhl, Yhl, Qxvi, Qxvi, Qxvi, Xoav, Xoav
Xoav, Xoav, Qxvi, Qxvi, Qxvi, Yhl, Yhl, Yhl, Qxvi, Qxvi, Qxvi, Xoav, Xoav
Xoav, Xoav, Xoav, Qxvi, Qxvi, Yhl, Yhl^Ii, Yhl, Qxvi, Qxvi, Xoav, Xoav, Xoav
Xoav, Xoav, Xoav, Xoav, Xoav, Yhl^Ii, 1 Yhl^Ii, Yhl^Ii, Xoav, Xoav, Xoav, Xoav, Xoav
Xoav, Xoav, Xoav, Xoav, Xoav, Xoav, Xoav, Xoav, Xoav, Xoav, Xoav, Xoav, Xoav
