Xos, Xos, Xos, Xos, Xol, Xos, Xos, Xos, Xol, Xos, Xos, Xos, Xos
Xos, Xos, Xos, Xol, Urb, Urb, Urb, Urb, Urb, Xol, Xos, Xos, Xos
Xos, Xos, Urb, Urb, Xos, Urb, Urb, Urb, Xos, Urb, Urb, Xos, Xos
Xos, Xos, Urb, Urb, Urb, Xos, Xos, Xos, Urb, Urb, Urb, Xos, Xos
Xos, Xos, Xol, Xol, Urb, Urb, Urb, Urb, Urb, Xol, Xol, Xos, Xos
Xos, Xos, Urb, Urb, Urb, Xol, Xol, Xol, Urb, Urb, Urb, Xos, Xos
Xos, Xos, Urb, Xos, Xol, Urb, Urb, Urb, Xol, Xos, Urb, Xos, Xos
Xos, Xos, Urb, Urb, Urb, Xol, Xos, Xol, Urb, Urb, Urb, Xos, Xos
Xos, Xos, Urb, Urb, Xos, Urb, Urb, Urb, Xos, Urb, Urb, Xos, Xos
Xos, Xos, Xos, Urb, Xos, Urb, Ur^Ii, Urb, Xos, Urb, Xos, Xos, Xos
Xos, Xos, Xos, Xos, Xos, Ur^Ii, 1 Ur^Ii, Ur^Ii, Xos, Xos, Xos, Xos, Xos
Xos, Xos, Xos, Xos, Xos, Xos, Xos, Xos, Xos, Xos, Xos, Xos, Xos
