Qxua, Qxua, Qxua, Qxua, Qxua, Qxua, Qxua, Qxua, Qxua, Qxua, Qxua, Qxua, Qxua
Qxua, Qxua, Qxua, Qxua, Qxua, Qxua, Rr, Qxua, Qxua, Qxua, Qxua, Qxua, Qxua
Qxua, Qxua, Ur^Xbl, Ur^Xbl, Ur, Rr, Rr, Rr, Ur, Ur, Ur^Xbl, Qxua, Qxua
Qxua, Qxua, Ur^Xbl, Ur^Xbl, Ur, Rr, Rr, Rr, Ur, Ur^Xbl, Ur^Xbl, Qxua, Qxua
Qxua, Qxua, Ur, Ur^Xbl, Ur^Xbl, Ur, Ur, Ur, Ur^Xbl, Ur^Xbl, Ur^Xbl, Qxua, Qxua
Qxua, Qxua, Ur, Ur^Por, Ur^Xbl, Ur, Ur, Ur^Xbl, Ur, Ur^Por, Ur, Qxua, Qxua
Qxua, Qxua, Ur, Ur, Ur^Xbl, Ur, Ur, Ur, Ur, Ur, Ur, Qxua, Qxua
Qxua, Qxua, Ur, Ur, Ur, Ur, Ur, Ur, Ur^Xbl, Ur, Ur, Qxua, Qxua
Qxua, Ur, Ur^Xbl, Ur, Ur, Ur, Ur^Xbl, Ur^Xbl, Ur^Por, Ur^Xbl, Ur^Xbl, Ur, Qxua
Qxua, Ur, Ur, Ur^Xbl, Ur^Xbl, Ur^Xbl, Ur^Ii, Ur, Ur, Ur, Ur, Ur, Qxua
Qxua, Qxua, Qxua, Ur, Ur, Ur^Ii, 1 Ur^Ii, Ur^Ii, Qxua, Qxua, Qxua, Qxua, Qxua
Qxua, Qxua, Qxua, Qxua, Qxua, Qxua, Qxua, Qxua, Qxua, Qxua, Qxua, Qxua, Qxua
