Qxua, Qxua, Qxua, Qxua, Qxua, Qxua, Qxua, Qxua, Qxua, Qxua, Qxua, Qxua, Qxua
Qxua, Qxua, Qxua, Qxua, Qxua, Qxua, Rr, Qxua, Qxua, Qxua, Qxua, Qxua, Qxua
Qxua, Qxua, Qxua, Qxua, Qxua, Rr, Rr, Rr, Qxua, Qxua, Qxua, Qxua, Qxua
Qxua, Qxua, Qxua, Qxua, Qxua^Bsb/, Rr, Rr, Rr, Qxua, Qxua, Xoa, Xoa, Xoa
Qxua, Qxua, Rb, Qxua^Bsb/, Qxua, Qxua, Qxua, Qxua, Qxua, Qxua, Ur, Ur, Xoa
Qxua, Qxua, Rb, Tb, Rb^Fetd, Qxua, Qxua, Qxua, Rb^Fdw, Qxua, Qxua, Ur, Xoa
Qxua, Qxua, Rb, Tb, Qxua, Qxua, Qxua, Rb^Fdw, Rb, Rb^Fdw, Qxua^Bsb/, Ur, Xoa
Qxua, Qxua, Qxua^Bsb|, Qxua, Rb, Rb, Qxua^Bsb/, Rb, Rb, Rb, Qxua, Qxua, Qxua
Qxua, Qxua, Qxua^Bsb|, Qxua, Qxua^Bsb/, Rb, Qxua, Qxua, Qxua, Qxua^Bsb|, Rb, Qxua, Qxua
Qxua, Qxua, Rb, Rb, Qxua, Qxua, Ur^Ii, Qxua, Qxua^Bsb/, Rb, Rb, Qxua, Qxua
Qxua, Qxua, Qxua, Rb, Qxua, Ur^Ii, 1 Ur^Ii, Ur^Ii, Qxua, Qxua, Qxua, Qxua, Qxua
Qxua, Qxua, Qxua, Qxua, Qxua, Qxua, Qxua, Qxua, Qxua, Qxua, Qxua, Qxua, Qxua
