Xos, Xos, Xos, Xos, Xos^Efs, Xos, Xos, Xos, Xos^Efs, Xos, Xos, Xos, Xos
Xos, Xos, Xos, Xos^Efs, Urb, Urb, Urb, Urb, Urb, Xos^Efs, Xos, Xos, Xos
Xos, Xos, Urb, Urb, Xos, Urb, Urb, Urb, Xos, Urb, Urb, Xos, Xos
Xos, Xos, Urb, Urb, Urb, Xos, Xos, Xos, Urb, Urb, Urb, Xos, Xos
Xos, Xos, Xos^Efs, Xos^Efs, Urb, Urb, Urb, Urb, Urb, Xos^Efs, Xos^Efs, Xos, Xos
Xos, Xos, Urb, Urb, Urb, Xos^Efs, Xos^Efs, Xos^Efs, Urb, Urb, Urb, Xos, Xos
Xos, Xos, Urb, Xos, Xos^Efs, Urb, Urb, Urb, Xos^Efs, Xos, Urb, Xos, Xos
Xos, Xos, Urb, Urb, Urb, Xos^Efs, Xos, Xos^Efs, Urb, Urb, Urb, Xos, Xos
Xos, Xos, Urb, Urb, Xos, Urb, Urb, Urb, Xos, Urb, Urb, Xos, Xos
Xos, Xos, Xos, Urb, Xos, Urb, Ur^Ii, Urb, Xos, Urb, Xos, Xos, Xos
Xos, Xos, Xos, Xos, Xos, Ur^Ii, 1 Ur^Ii, Ur^Ii, Xos, Xos, Xos, Xos, Xos
Xos, Xos, Xos, Xos, Xos, Xos, Xos, Xos, Xos, Xos, Xos, Xos, Xos
