Xoc, Xoc, Xoc, Xoc, Xoc, Xoc, Xoc, Xoc, Xoc, Xoc, Xoc, Xoc, Xoc
Xoc, Xoc, Xoc, Xoc^Efs, Isr, Isr, Isr, Isr, Isr, Xoc^Efs, Xoc^Exw, Xoc, Xoc
Xoc, Xoc, Isr, Qxua, Qxua^Bsb/, Isr, Isr, Isr, Qxua^Bsb\, Qxua, Isr, Xoc, Xoc
Xoc, Isr, Xoc^Efs, Isr, Isr, Qxua, Qxua, Qxua, Isr, Isr, Xoc^Efs, Isr, Xoc
Xoc, Isr, Isr, Isr, Isr, Isr, Kf, Isr, Isr, Isr, Isr, Isr, Xoc
Xoc, Isr, Isr, Isr, Xoc^Efs, Isr, Isr, Isr, Xoc^Efs, Isr, Isr, Isr, Xoc
Xoc, Isr, Isr^Pob, Isr, Isr, Isr, Qxua, Isr, Isr, Isr, Isr^Pob, Isr, Xoc
Xoc, Isr, Isr, Isr, Qxua^Bsb\, Qxua, Isr, Qxua, Qxua^Bsb/, Isr, Isr, Isr, Xoc
Xoc, Isr, Qxua, Qxua^Bsb\, Isr, Isr, Isr, Isr, Isr, Qxua^Bsb/, Qxua, Isr, Xoc
Qxua, Qxua, Xoc, Isr, Isr, Isr, Isr^Ii, Isr, Isr, Isr, Xoc, Qxua, Qxua
Xoc, Xoc, Xoc, Xoc, Xoc, Isr^Ii, 1 Isr^Ii, Isr^Ii, Xoc, Xoc, Xoc, Xoc, Xoc
Xoc, Xoc, Xoc, Xoc, Xoc, Xoc, Xoc, Xoc, Xoc, Xoc, Xoc, Xoc, Xoc
