Qxua, Qxua, Qxua, Qxua, Qxua, Qxua, Xoa, Qxua, Qxua, Qxua, Qxua, Qxua, Qxua
Qxua, Qxua, Qxua, Qxua, Xoa, Xoa, Rr, Xoa, Xoa, Qxua, Qxua, Qxua, Qxua
Qxua, Qxua, Xoa, Xoa, Ur, Rr, Rr, Rr, Ur, Xoa, Xoa, Qxua, Qxua
Qxua, Qxua, Ur, Ur^Maus, Ur, Rr, Rr, Rr, Ur, Ur^Mauz, Ur, Qxua, Qxua
Qxua, Qxua, Ur, Ur, Ur, Ur, Ur, Ur, Ur, Ur, Ur, Qxua, Qxua
Qxua, Qxua, Urc, Ur, Urc, Xoa, Xoa, Xoa, Urc, Ur, Urc, Qxua, Qxua
Qxua, Qxua, Urc, Urc, Urc, Xoa, Xoa^Efs, Xoa, Urc, Urc, Urc, Qxua, Qxua
Qxua, Qxua, Ur, Ur, Ur, Xoa, Ur^Efs, Xoa, Ur, Ur, Ur, Qxua, Qxua
Qxua, Qxua, Ur, Ur, Ur, Ur^Efs, Ur, Ur, Ur, Ur, Ur, Qxua, Qxua
Qxua, Qxua, Xoa, Ur, Ur, Ur, Ur^Ii, Ur, Ur, Ur, Xoa, Qxua, Qxua
Qxua, Qxua, Qxua, Xoa, Xoa, Ur^Ii, 1 Ur^Ii, Ur^Ii, Xoa, Xoa, Qxua, Qxua, Qxua
Qxua, Qxua, Qxua, Qxua, Qxua, Xoa, Xoa, Xoa, Qxua, Qxua, Qxua, Qxua, Qxua
