Xyui, Xyui, Xyui, Xyui, Xyui, Xyui, Xos, Xyui, Xyui, Xyui, Xyui, Xyui, Xyui
Xyui, Xyui, Xyui, Xyui, Xos, Xos^Efs, Rra, Xos^Efs, Xos, Xyui, Xyui, Xyui, Xyui
Xyui, Xyui, Aa^Aybl, Xos, Xos, Rra, Rra, Rra, Xos, Xos, Aa^Aybl, Xyui, Xyui
Xyui, Aa^Aybl, Ai, Aa, Rra, Rra, Rra, Rra, Rra, Aa, Ai, Aa^Aybl, Xyui
Xyui, Ai, Qxaz, Aa, Xos, Rra, Rra, Rra, Xos, Aa, Qxaz, Ai, Xyui
Xyui, Ai, Aa, Aa, Xos, Rra, Rra, Rra, Xos, Aa, Aa, Ai, Xyui
Xyui, Aa, Aa, Aa^Pob, Xos^Efs, Rra, Rra, Rra, Xos^Efs, Aa^Pob, Aa, Aa, Xyui
Xyui, Ai, Qxaz, Aa, Aa, Rra, Xos, Rra, Aa, Aa, Qxaz, Ai, Xyui
Xyui, Ai, Ai, Aa, Aa, Aa, Aa, Aa, Aa, Aa, Ai, Ai, Xyui
Xyui, Ha, Ha, Aa^Feta, Aa, Aa, Rra^Ii, Aa, Aa, Aa^Feta, Ha, Ha, Xyui
Xyui, Ms, Xyui, Ha, Xyui, Rra^Ii, 1 Rra^Ii, Rra^Ii, Xyui, Ha, Xyui, Ms, Xyui
Xyui, Xyui, Xyui, Xyui, Xyui, Xyui, Xyui, Xyui, Xyui, Xyui, Xyui, Xyui, Xyui
