Ww, Ww, Xu, Xu, Xu, Xu, Xu, Xu, Xu, Xu, Xu, Xu, Xu
Ww, Ww, Ww, Xu, Ds, Uu, Uu, Uu, Ds, Xu, Xu, Xu, Xu
Xu, Ww, Wwf, Wwf, Wwf, Ds, Ds, Ds, Wwf, Ds, Ds, Xu, Xu
Xu, Wwf, Wwf, Wwf, Xu, Ww, Xu, Ww, Ww, Wwf, Wwf, Ds, Xu
Xu, Ds, Wwf, Xu, Ww, Ww, Xu, Wo, Ww, Ww, Wwf, Ds, Xu
Xu, Ds, Wwf, Xu, Ww, Wo^Ewl, Wo^Ewf, Wo^Ewl, Ww, Ww, Wwf, Ds, Xu
Xu, Ds, Wwf, Ww, Ww, Wo^Ewl, Xu, Wo^Ewl, Ww, Xu, Wwf, Ds, Xu
Xu, Ds, Wwf, Ww, Ww, Wo, Xu, Ww, Xu, Xu, Wwf, Ds, Xu
Xu, Ds, Ds, Wwf, Wwf, Ww, Ds, Ww, Wwf, Wwf, Wwf, Wwf, Ww
Xu, Xu, Xu, Ds, Ds, Ds, Ur^Ii, Ds, Ds, Wwf, Ww, Ww, Ww
Xu, Xu, Xu, Xu, Xu, Ur^Ii, 1 Ur^Ii, Ur^Ii, Xu, Xu, Xu, Ww, Ww
Xu, Xu, Xu, Xu, Xoa, Xu, Xu, Xu, Xu, Xu, Xu, Ww, Ww
