Xos, Xos, Xos, Xos, Xol, Xos, Xos, Xos, Xol, Xos, Xos, Xos, Xos
Xos, Xos, Xos, Xol, Xol, Xol, Urb, Xol, Xol, Xol, Xos, Xos, Xos
Xos, Xos, Urb, Urb, Urb, Urb, Urb, Urb, Urb, Urb, Urb, Xos, Xos
Xos, Xos, Urb, Xos, Urb, Urb, Urb, Urb, Urb, Xos, Urb, Xos, Xos
Xos, Xos, Urb, Urb, Urb, Xos, Urb, Xos, Urb, Urb, Urb, Xos, Xos
Xos, Xos, Urb, Xos, Urb, Urb, Urb, Urb, Urb, Xos, Urb, Xos, Xos
Xos, Xos, Urb, Urb, Urb, Xos, Urb, Xos, Urb, Urb, Urb, Xos, Xos
Xos, Xos, Urb, Xos, Urb, Urb, Urb, Urb, Urb, Xos, Urb, Xos, Xos
Xos, Xos, Urb, Urb, Urb, Xos, Urb, Xos, Urb, Urb, Urb, Xos, Xos
Xos, Xos, Xos, Urb, Urb, Urb, Ur^Ii, Urb, Urb, Urb, Xos, Xos, Xos
Xos, Xos, Xos, Xos, Xos, Ur^Ii, 1 Ur^Ii, Ur^Ii, Xos, Xos, Xos, Xos, Xos
Xos, Xos, Xos, Xos, Xos, Xos, Xos, Xos, Xos, Xos, Xos, Xos, Xos
