Xos, Xos, Xos, Xos, Xol, Xos, Xos, Xos, Xol, Xos, Xos, Xos, Xos
Xos, Xos, Xos, Xol, Urb, Urb, Urb, Urb, Urb, Xol, Xos, Xos, Xos
Xos, Xos, Xos, Xos, Xos, Urb, Urb, Urb, Xos, Xos, Xos, Xos, Xos
Xos, Xos, Urb, Urb, Urb, Urb, Urb, Urb, Urb, Urb, Urb, Xos, Xos
Xos, Xos, Urb^Por, Urb, Urb, Urb, Xos, Urb, Urb, Urb, Urb^Pob, Xos, Xos
Xos, Xos, Xol, Xol, Urb, Urb, Xos, Urb, Urb, Xol, Xol, Xos, Xos
Xos, Xos, Urb, Urb, Urb, Urb^Pob, Xos, Urb^Por, Urb, Urb, Urb, Xos, Xos
Xos, Xos, Urb, Urb, Xol, Xol, Urb, Xol, Xol, Urb, Urb, Xos, Xos
Xos, Xos, Xos, Xos, Urb^Pob, Urb, Urb, Urb, Urb^Por, Xos, Xos, Xos, Xos
Xos, Xos, Xos, Urb, Urb, Urb, Ur^Ii, Urb, Urb, Urb, Xos, Xos, Xos
Xos, Xos, Xos, Xos, Xos, Ur^Ii, 1 Ur^Ii, Ur^Ii, Xos, Xos, Xos, Xos, Xos
Xos, Xos, Xos, Xos, Xos, Xos, Xos, Xos, Xos, Xos, Xos, Xos, Xos
