Xu, Xu, Xu, Xu, Xol, Xos, Xos, Xos, Xol, Xos, Xos, Xos, Xos
Qlf, Xu, Xu, Xu, Ur, Ur, Ur, Ur, Ur, Xol, Xos, Xos, Xos
Xu, Qlf, Qlf, Xu, Ur, Ur, Ur, Ur, Ur, Xos, Qxua, Xos, Xos
Xu, Xu, Ur, Ur, Ur, Ur, Ur, Ur, Ur, Ur, Ur, Xos, Xos
Qlf, Xu, Qlf, Ur, Qlf, Ur, Ur, Qxua, Ur, Ur, Qxua, Xos, Xos
Xu, Qlf, Qlf, Ur, Ur, Ur, Ur, Ur, Qxua, Ur, Ur, Xos, Xos
Xu, Xu, Qlf, Ur, Qlf, Qlf, Ur, Ur, Qxua, Qxua, Ur, Xos, Xos
Xu, Xu, Ur, Ur, Ur, Ur, Ur, Ur, Ur, Qxua, Ur, Xos, Xos
Qlf, Xu, Ur, Ur, Qlf, Ur, Ur, Ur, Ur, Ur, Qxua, Xos, Xos
Xu, Qlf, Qlf, Qlf, Ur, Ur, Ur^Ii, Ur, Ur, Ur, Xos, Xos, Xos
Xu, Xu, Xu, Xu, Xos, Ur^Ii, 1 Ur^Ii, Ur^Ii, Xos, Xos, Xos, Xos, Xos
Xu, Xu, Xu, Xu, Xos, Xos, Xos, Xos, Xos, Xos, Xos, Xos, Xos
