Xos, Xos, Xos, Xos, Xos^Efs, Xos, Xos, Xos, Xos^Efs, Xos, Xos, Xos, Xos
Xos, Xos, Xos, Xos^Efs, Urb, Urb, Urb, Urb, Urb, Xos^Efs, Xos, Xos, Xos
Xos, Xos, Xos, Xos, Xos, Urb, Urb, Urb, Xos, Xos, Xos, Xos, Xos
Xos, Xos, Urb, Urb, Urb, Urb, Urb, Urb, Urb, Urb, Urb, Xos, Xos
Xos, Xos, Urb^Por, Urb, Urb, Urb, Xos, Urb, Urb, Urb, Urb^Pob, Xos, Xos
Xos, Xos, Xos^Efs, Xos^Efs, Urb, Urb, Xos, Urb, Urb, Xos^Efs, Xos^Efs, Xos, Xos
Xos, Xos, Urb, Urb, Urb, Urb^Pob, Xos, Urb^Por, Urb, Urb, Urb, Xos, Xos
Xos, Xos, Urb, Urb, Xos^Efs, Xos^Efs, Urb, Xos^Efs, Xos^Efs, Urb, Urb, Xos, Xos
Xos, Xos, Xos, Xos, Urb^Pob, Urb, Urb, Urb, Urb^Por, Xos, Xos, Xos, Xos
Xos, Xos, Xos, Urb, Urb, Urb, Ur^Ii, Urb, Urb, Urb, Xos, Xos, Xos
Xos, Xos, Xos, Xos, Xos, Ur^Ii, 1 Ur^Ii, Ur^Ii, Xos, Xos, Xos, Xos, Xos
Xos, Xos, Xos, Xos, Xos, Xos, Xos, Xos, Xos, Xos, Xos, Xos, Xos
