Xu, Xu, Xu, Xu, Xu, Xu, Xoa, Xu, Xu, Xu, Xoav, Xu, Xu
Xu, Xu, Xu, Xu, Xoa, Xoa, Urb, Xoa, Xoa, Xoav, Qxvi, Xoav, Xoav
Xu, Xu, Xu, Xu, Xoa, Urb, Urb, Urb, Xoa, Xoav, Qxvi, Qxvi, Xoav
Xu, Xu, Xu, Xu, Xoa^Efs, Urb, Urb, Urb, Xoa^Efs, Xoav, Qxvi, Qxvi, Xoav
Xu, Xu, Urb, Urb, Urb, Urb, Urb, Urb, Urb, Yhl, Yhl, Qxvi, Xoav
Xu, Xu, Urb, Xoa^Efs, Urb, Urb, Urb, Urb, Urb, Xoa^Efs, Yhl, Yhl, Xoav
Xu, Xu, Urb, Urb, Urb, Urb, Urb, Urb, Urb, Urb, Urb, Xoav, Xu
Xu, Xu, Urb, Urb, Urb, Urb, Urb, Urb, Urb, Urb, Urb, Xu, Xu
Xu, Xu, Urb, Xoa^Efs, Urb, Urb, Urb, Urb, Urb, Xoa^Efs, Urb, Xu, Xu
Xu, Xu, Xu, Urb, Urb, Urb, Urb^Ii, Urb, Urb, Urb, Xu, Xu, Xu
Xu, Xu, Xu, Xu, Xu, Urb^Ii, 1 Urb^Ii, Urb^Ii, Xu, Xu, Xu, Xu, Xu
Xu, Xu, Xu, Xu, Xu, Xu, Xu, Xu, Xu, Xu, Xu, Xu, Xu
