Xu, Xu, Xu, Xu, Xu, Xu, Xu, Xu, Xu, Xu, Xu, Xu, Xu
Xu, Xu, Xu, Xu, Ds, Ds, Ds, Ds, Ds, Xu, Xu, Xu, Xu
Xu, Xu, Ww, Ww, Wwf, Ds, Ds, Ds, Wwf, Ww, Ww, Xu, Xu
Ww, Ww, Wwf, Wwf, Wwf^Pob, Wwf, Wwf, Wwf, Wwf, Wwf, Wwf, Ww, Ww
Ww, Ww, Ww, Wwf, Wwf, Wwf, Wwf, Wwf, Wwf, Wwf, Ww, Ww, Ww
Ww, Ds, Ds, Wwf, Wwf, Ww, Ww, Ww, Wwf, Wwf, Ds, Ds, Ww
Ww, Ds, Ww, Wwf, Wwf, Ww, Wwf, Ww, Wwf, Wwf, Ww, Ds, Ww
Ww, Ww, Wwf, Wwf, Wwf, Wwf, Wwf, Wwf, Wwf^Pob, Wwf, Wwf, Ww, Ww
Xu, Ww, Ww, Wwf, Wwf, Wwf, Ds, Wwf, Wwf, Wwf, Ww, Ww, Xu
Xu, Xu, Xu, Wwf, Ds, Ds, Ur^Ii, Ds, Ds, Wwf, Xu, Xu, Xu
Xu, Xu, Xu, Xu, Xu, Ur^Ii, 1 Ur^Ii, Ur^Ii, Xu, Xu, Xu, Xu, Xu
Xu, Xu, Xu, Xu, Xu, Xu, Xu, Xu, Xu, Xu, Xu, Xu, Xu
