Xof, Xof, Xof, Xof, Xof, Xof, Xof, Xof, Xof, Xof, Xof, Xof, Xof
Xof, Xof, Xof, Xof, Xof, Xof, Rp, Xof, Xof, Xof, Xof, Xof, Xof
Xof, Xof, Xof, Xof, Gs, Rp, Rp, Rp, Gs, Xof, Xof, Xof, Xof
Xof, Xof, Gll^Ftr, Gll^Ftr, Gs, Rp, Rp, Rp, Gs, Gll^Ftr, Gll^Ftr, Xof, Xof
Xof, Xof, Gll^Ftr, Gs, Xof, Xof, Rp, Xof, Xof, Gs, Gll^Ftr, Xof, Xof
Xof, Xof, Gs, Gs, Xof, Rp, Gll^Ftr, Rp, Xof, Gs, Gs, Xof, Xof
Xof, Xof, Gs, Gs, Xof, Rp, Rp, Rp, Xof, Gs, Gs, Xof, Xof
Xof, Xof, Gll^Ftr, Gs, Gs, Xof, Rp, Xof, Gs, Gs, Gll^Ftr, Xof, Xof
Xof, Xof, Gll^Ftr, Gs, Gs, Gll^Ftr, Rp, Gll^Ftr, Gs, Gs, Gll^Ftr, Xof, Xof
Xof, Xof, Xof, Gll^Ftr, Gs, Gs, Rp^Ii, Gs, Gs, Gll^Ftr, Xof, Xof, Xof
Xof, Xof, Xof, Xof, Xof, Rp^Ii, 1 Rp^Ii, Rp^Ii, Xof, Xof, Xof, Xof, Xof
Xof, Xof, Xof, Xof, Xof, Xof, Xof, Xof, Xof, Xof, Xof, Xof, Xof
