Xos, Xos, Xos, Xos, Xos^Efs, Xos, Xos, Xos, Xos^Efs, Xos, Xos, Xos, Xos
Xos, Xos, Xot, Xos, Xos, Xos^Efs, Urb, Xos^Efs, Xos, Xos, Xot, Xos, Xos
Xos, Xot, Urb, Urb, Urb, Urb, Urb, Urb, Urb, Urb, Urb, Xos, Xos
Xos, Xos, Urb, Urb, Xos, Urb, Urb, Urb, Xos, Urb, Urb, Xos, Xos
Xos, Xos, Urb, Urb, Urb, Urb, Urbm^Maus, Urb, Urb, Urb, Urb, Xos, Xos
Xos, Xos, Urb, Urb, Xos, Urb, Urb, Urb, Xos, Urb, Urb, Xos, Xos
Xos, Xos, Xot, Urb, Urb, Urb, Urb, Urb, Urb, Urb, Xot, Xos, Xos
Xos, Xot, Urb, Urb, Xos, Urb, Urb, Urb, Xos, Urb, Urb, Xos, Xos
Xos, Xos, Urb, Urb, Urb, Urb, Urb, Urb, Urb, Urb, Urb, Xos, Xos
Xos, Xos, Xos, Urb, Xos, Urb, Ur^Ii, Urb, Xos, Urb, Xos, Xos, Xos
Xos, Xos, Xos, Xos, Xos, Ur^Ii, 1 Ur^Ii, Ur^Ii, Xos, Xos, Xos, Xos, Xos
Xos, Xos, Xos, Xos, Xos, Xos, Xos, Xos, Xos, Xos, Xos, Xos, Xos
