Qxua, Qxua, Qxua, Qxua, Qxua, Qxua, Qxua, Qxua, Qxua, Qxua, Qxua, Qxua, Qxua
Qxua, Qxua, Qxua, Qxua, Qxua, Qxua, Rr, Qxua, Qxua, Qxua, Qxua, Qxua, Qxua
Qxua, Qxua, Qxua, Qxua, Ur^Maus, Rr, Rr, Rr, Ur^Mauz, Qxua, Qxua, Qxua, Qxua
Qxua, Qxua, Cfr, Ur, Ur, Rr, Rr, Rr, Ur, Ur, Cfr, Qxua, Qxua
Qxua, Qxua, Ur, Ur^Dr, Ur, Ur, Ur^Dr, Ur, Ur, Ur, Ur, Qxua, Qxua
Qxua, Qxua, Ur, Ur, Ur, Cfr, Kfr, Qxua, Qxua, Ur, Ur, Qxua, Qxua
Qxua, Qxua, Ur^Dr, Ur, Ur, Ur^Dr, Cfr, Qxua, Qxua, Cfr, Ur, Qxua, Qxua
Qxua, Qxua, Qxua, Qxua^Bsb|, Qxua, Ur, Ur, Ur^Dr, Qxua, Ur^Dr, Ur, Qxua, Qxua
Qxua, Qxua, Cfr, Ur, Ur, Qxua, Qxua, Qxua^Bsb\, Ur, Ur, Cfr, Qxua, Qxua
Qxua, Qxua, Qxua, Ur^Dr, Ur, Ur, Ur^Ii, Ur, Ur, Ur, Qxua, Qxua, Qxua
Qxua, Qxua, Qxua, Qxua, Qxua, Ur^Ii, 1 Ur^Ii, Ur^Ii, Qxua, Qxua, Qxua, Qxua, Qxua
Qxua, Qxua, Qxua, Qxua, Qxua, Qxua, Qxua, Qxua, Qxua, Qxua, Qxua, Qxua, Qxua
