Xuc, Xuc, Xuc, Xuc, Xuc, Xuc, Xuc, Xuc, Xuc, Xuc, Xuc, Xuc, Xuc
Xuc, Xuc, Co, Xuc, Ur, Xuc, Ur, Xuc, Ur, Xuc, Co, Xuc, Xuc
Xuc, Xuc, Ur, Ur, Ur^Ecf, Ur, Ur, Ur, Ur^Ecf, Ur, Ur, Xuc, Xuc
Xuc, Xuc, Ur, Ur, Ur, Urc, Urc, Urc, Ur, Ur, Ur, Xuc, Xuc
Xuc, Xuc, Ur, Qlf, Ur, Urc, Ko, Urc, Ur, Qlf, Ur, Xuc, Xuc
Xuc, Xuc, Ur, Qlf, Ur, Urc, Urc, Urc, Ur, Qlf, Ur, Xuc, Xuc
Xuc, Co, Ur, Qlf^Bsb\, Ur, Urc, Urc, Urc, Ur, Qlf^Bsb/, Ur, Co, Xuc
Xuc, Xuc, Ur, Qlf, Ur, Urc, Ur, Urc, Ur, Qlf, Ur, Xuc, Xuc
Xuc, Xuc, Ur, Qlf, Ur^Ecf, Ur, Ur, Ur, Ur^Ecf, Qlf, Ur, Xuc, Xuc
Xuc, Xuc, Ur, Ur, Ur, Ur, Ur^Ii, Ur, Ur, Ur, Ur, Xuc, Xuc
Xuc, Xuc, Co, Ur, Ur, Ur^Ii, 1 Ur^Ii, Ur^Ii, Ur, Ur, Co, Xuc, Xuc
Xuc, Xuc, Xuc, Xuc, Xuc, Xuc, Xuc, Xuc, Xuc, Xuc, Xuc, Xuc, Xuc
