Xu, Xu, Xu, Xu, Xu, Xu, Xu, Xu, Xu, Xu, Xu, Xu, Xu
Xu, Xu, Xu, Xu, Xu, Xu, Rr, Xu, Xu, Xu, Xu, Xu, Xu
Xu, Xu, Xu, Xu, Wwf, Rr, Rr, Rr, Wwf, Xu, Xu, Xu, Xu
Xu, Xu, Wwf, Wwf, Ww, Rr, Ww, Rr, Ww, Wwf, Wwf, Xu, Xu
Xu, Ds, Wwf, Ww, Wo, Ww, Wo, Ww, Wo, Ww, Wwf, Ds, Xu
Xu, Ds, Wwf, Ww, Ww, Wo, Wo, Wo, Ww, Ww, Wwf, Ds, Xu
Xu, Ds, Wwf, Wwf^Pob, Ww, Wo, Wo, Wo, Ww, Wwf^Pob, Wwf, Ds, Xu
Xu, Ds, Wwf, Ww, Wo, Wo, Wo, Wo, Wo, Ww, Wwf, Ds, Xu
Xu, Ds, Wwf, Ww, Ww, Ww, Ww, Ww, Ww, Ww, Wwf, Ds, Xu
Xu, Xu, Xu, Wwf, Wwf, Ww, Ur^Ii, Ww, Wwf, Wwf, Xu, Xu, Xu
Xu, Xu, Xu, Xu, Xu, Ur^Ii, 1 Ur^Ii, Ur^Ii, Xu, Xu, Xu, Xu, Xu
Xu, Xu, Xu, Xu, Xu, Xu, Xu, Xu, Xu, Xu, Xu, Xu, Xu
