Xos, Xos, Xos, Xos, Xol, Xos, Xos, Xos, Xol, Xos, Xos, Xos, Xos
Xos, Xos, Xos, Xol, Ur, Ur, Ur^Ii, Ur, Ur, Xol, Xos, Xos, Xos
Xos, Xos, Ur, Xos, Ur, Ur^Ii, Ur^Ii, Ur^Ii, Ur, Xos, Ur, Xos, Xos
Xos, Xos, Ur, Ur, Ur, Ur^Ii, Ur^Ii, Ur^Ii, Ur, Ur, Ur, Xos, Xos
Xos, Xos, Ur, Uu^Maus, Ur, Ur, Ur, Ur, Ur, Uu^Mauz, Ur, Xos, Xos
Xos, Xos, Ur, Ur, Ur, Ur, Ur, Ur, Ur, Ur, Ur, Xos, Xos
Xos, Xos, Ur, Uu^Maus, Ur, Ur, Ur, Ur, Ur, Uu^Mauz, Ur, Xos, Xos
Xos, Xos, Ur, Ur, Ur, Ur, Ur, Ur, Ur, Ur, Ur, Xos, Xos
Xos, Xos, Ur, Uu^Maus, Ur, Ur, Ur, Ur, Ur, Uu^Mauz, Ur, Xos, Xos
Xos, Xos, Xos, Ur, Ur, Ur, Ur^Ii, Ur, Ur, Ur, Xos, Xos, Xos
Xos, Xos, Xos, Xos, Xos, Ur^Ii, 1 Ur^Ii, Ur^Ii, Xos, Xos, Xos, Xos, Xos
Xos, Xos, Xos, Xos, Xos, Xos, Xos, Xos, Xos, Xos, Xos, Xos, Xos
