Qxua, Qxua, Qxua, Qxua, Qxua, Qxua, Rb^Fdw, Qxua, Qxua, Qxua, Qxua, Qxua, Qxua
Qxua, Qxua, Qxua, Qxua, Rb^Fdw, Rb^Fdw, Uu, Rb^Fdw, Rb^Fdw, Qxua, Qxua, Qxua, Qxua
Qxua, Qxua, Rb^Fdw, Rb^Feth, Rb, Uu, Uu, Uu, Rb, Rb^Feth, Rb^Fdw, Qxua, Qxua
Qxua, Rb^Fdw, Uu, Uu, Rb, Uu, Uu, Uu, Rb, Uu, Uu, Rb^Fdw, Qxua
Qxua, Rb^Fdw, Uu, Rb^Fdw, Tb, Rb, Rb, Rb, Tb, Rb^Fdw, Uu, Rb^Fdw, Qxua
Qxua, Rb^Fdw, Uu, Rb^Fdw, Rb^Fetd, Tb, Rb, Tb, Rb^Fetd, Rb^Fdw, Uu, Rb^Fdw, Qxua
Qxua, Rb^Fdw, Uu, Rb^Fdw, Tb, Tb, Rb, Tb, Tb, Rb^Fdw, Uu, Rb^Fdw, Qxua
Qxua, Rb^Fdw, Tb, Uu, Rb, Rb, Ur, Rb, Rb, Uu, Tb, Rb^Fdw, Qxua
Qxua, Rb^Fdw, Rb^Fetd, Tb, Ur, Ur, Ur, Ur, Ur, Tb, Rb^Fetd, Rb^Fdw, Qxua
Qxua, Rb^Fdw, Rb^Fdw, Tb, Ur, Ur, Ur^Ii, Ur, Ur, Tb, Rb^Fdw, Rb^Fdw, Qxua
Qxua, Qxua, Qxua, Rb^Fdw, Rb^Fdw, Ur^Ii, 1 Ur^Ii, Ur^Ii, Rb^Fdw, Rb^Fdw, Qxua, Qxua, Qxua
Qxua, Qxua, Qxua, Qxua, Qxua, Rb^Fdw, Rb^Fdw, Rb^Fdw, Qxua, Qxua, Qxua, Qxua, Qxua
