Xu, Xu, Xu, Xu, Xol, Xos, Xos, Xos, Xol, Xos, Xos, Xos, Xos
Qlf, Xu, Xu, Xu, Ur, Ur, Ur, Ur, Ur, Xol, Xos, Xos, Xos
Xu, Qlf, Qlf, Ur, Ur, Ur, Ur, Ur, Ur, Ur, Ur, Xos, Xos
Xu, Ur, Ur, Ur, Ur, Ur, Ur, Qxua, Qxua, Ur, Ur, Qxua, Xos
Qlf, Ur, Qlf, Ur, Ur, Qlf, Ur, Qxua, Ur, Ur, Ur, Ur, Xos
Xu, Qlf, Qlf, Ur, Ur, Qlf, Ur, Ur, Qxua, Qxua, Ur, Ur, Xos
Xu, Ur, Qlf, Ur, Ur, Qlf, Ur, Ur, Qxua, Qxua, Ur, Ur, Xos
Xu, Ur, Ur, Ur, Ur, Ur, Ur, Ur, Ur, Ur, Ur, Ur, Xos
Qlf, Ur, Ur, Ur, Qlf, Ur, Ur, Ur, Ur, Ur, Qxua, Qxua, Xos
Xu, Qlf, Qlf, Qlf, Ur, Ur, Ur^Ii, Ur, Ur, Ur, Xos, Xos, Xos
Xu, Xu, Xu, Xu, Xos, Ur^Ii, 1 Ur^Ii, Ur^Ii, Xos, Xos, Xos, Xos, Xos
Xu, Xu, Xu, Xu, Xos, Xos, Xos, Xos, Xos, Xos, Xos, Xos, Xos
