Xu, Xu, Xu, Xu, Xu, Xu, Xu, Xu, Xu, Xu, Xu, Xu, Xu
Xu, Xu, Xu, Xu, Xu, Xu, Uu^Wyb, Xu, Xu, Xu, Xu, Xu, Xu
Xu, Xu, Xu, Xu, Ur, Ur, Ur, Ur, Ur, Xu, Xu, Xu, Xu
Xu, Xu, Ur, Ur, Ur, Ur, Xu, Ur, Ur, Ur, Ur, Xu, Xu
Xu, Xu, Ur, Ur, Xu, Xu, Uu^Wyb, Xu, Xu, Ur, Ur, Xu, Xu
Xu, Xu, Ur, Uu^Wyb, Xu, Ur, Ur, Ur, Xu, Uu^Wyb, Ur, Xu, Xu
Xu, Xu, Ur, Xu, Xu, Uu^Wyb, Ur, Uu^Wyb, Xu, Xu, Ur, Xu, Xu
Xu, Xu, Ur, Ur, Ur, Xu, Ur, Xu, Ur, Ur, Ur, Xu, Xu
Xu, Xu, Uu^Wyb, Ur, Ur, Ur, Ur, Ur, Ur, Ur, Uu^Wyb, Xu, Xu
Xu, Xu, Xu, Ur, Ur, Ur, Ur^Ii, Ur, Ur, Ur, Xu, Xu, Xu
Xu, Xu, Xu, Xu, Xu, Ur^Ii, 1 Ur^Ii, Ur^Ii, Xu, Xu, Xu, Xu, Xu
Xu, Xu, Xu, Xu, Xu, Xu, Xu, Xu, Xu, Xu, Xu, Xu, Xu
