Xyui, Xyui, Xyui, Xyui, Xyui, Xyui, Xyui, Xyui, Xyui, Xyui, Xyui, Xyui, Xyui
Xyui, Xyui, Xyui, Xyui, Xyui, Xyui, Xyui, Xyui, Xyui, Xyui, Xyui, Xyui, Xyui
Xyui, Xyui, Ai, Ai, Aa, Aa, Aa, Aa, Aa, Ai, Ai, Xyui, Xyui
Xyui, Xyui, Ai, Aa, Aa^Aybl, Aa, Aa, Aa, Aa^Aybl, Aa, Ai, Xyui, Xyui
Xyui, Xyui, Ai, Aa^Aybl, Aa, Aa^Aybl, Aa, Aa^Aybl, Aa, Aa^Aybl, Ai, Xyui, Xyui
Xyui, Xyui, Ai, Aa^Aybl, Aa, Aa, Aa, Aa, Aa, Aa^Aybl, Ai, Xyui, Xyui
Xyui, Xyui, Ai, Aa, Aa, Aa^Aybl, Aa^Aybl, Aa^Aybl, Aa, Aa, Ai, Xyui, Xyui
Xyui, Xyui, Ai, Aa^Aybl, Aa, Aa, Aa, Aa, Aa, Aa^Aybl, Ai, Xyui, Xyui
Xyui, Xyui, Ha, Ai, Aa^Aybl, Aa, Aa, Aa, Aa^Aybl, Ai, Ha, Xyui, Xyui
Xyui, Xyui, Aa^Aybl, Ha, Ha, Aa^Aybl, Rra, Aa^Aybl, Ha, Ha, Aa^Aybl, Xyui, Xyui
Xyui, Xyui, Xyui, Xyui, Xyui, Rra, 1 Rra, Rra, Xyui, Xyui, Xyui, Xyui, Xyui
Xyui, Xyui, Xyui, Xyui, Xyui, Xyui, Xyui, Xyui, Xyui, Xyui, Xyui, Xyui, Xyui
