Xyui, Xyui, Xyui, Xyui, Xyui, Xyui, Xyui, Xyui, Xyui, Xyui, Xyui, Xyui, Xyui
Xyui, Xyui, Xyui, Xyui, Xyui, Xyui, Xyui, Xyui, Xyui, Xyui, Xyui, Xyui, Xyui
Xyui, Xyui, Ms, Xyui, Aa, Aa, Aa, Aa, Aa^Esa, Xyui, Ms, Xyui, Xyui
Xyui, Xyui, Ha, Ha, Aa, Aa^Esa, Aa, Aa, Aa, Ha, Ha, Xyui, Xyui
Ai, Xyui, Xyui, Aa, Aa, Aa, Aa^Fpa, Aa, Aa^Esa, Aa, Aa, Xyui, Xyui
Wwg, Ai, Wwf, Wwf, Ai, Aa^Fpa, Aa^Feta, Aa^Fpa, Ai, Wwf, Wwf, Wwg, Wwg
Xyui, Wwg, Ai, Wwf, Wwf, Aa^Fpa, Ai, Aa^Fpa, Wwf, Wwf, Xyui, Ai, Ai
Xyui, Xyui, Aa, Ai, Aa^Esa, Wwf, Wwf, Wwf, Ai, Ai, Aa, Xyui, Xyui
Xyui, Xyui, Ha, Aa, Aa, Aa, Aa, Aa^Esa, Aa^Esa, Aa, Ha, Xyui, Xyui
Xyui, Xyui, Ms, Ha, Aa, Aa, Rra, Aa, Aa, Ha, Ms, Xyui, Xyui
Xyui, Xyui, Xyui, Xyui, Xyui, Rra, 1 Rra, Rra, Xyui, Xyui, Xyui, Xyui, Xyui
Xyui, Xyui, Xyui, Xyui, Xyui, Xyui, Xyui, Xyui, Xyui, Xyui, Xyui, Xyui, Xyui
