Xyui, Xyui, Xyui, Xyui, Xyui, Xyui, Xyui, Xyui, Xyui, Xyui, Xyui, Xyui, Xyui
Xyui, Xyui, Xyui, Xyui, Xyui, Xyui, Xyui, Xyui, Xyui, Xyui, Ms, Xyui, Xyui
Qxaz, Xyui, Aa^Fpa, Aa^Fpa, Aa, Aa, Aa, Aa, Ha, Ms, Ms, Xyui, Xyui
Qxaz, Qxaz, Aa, Aa, Aa^Fpa, Aa, Aa, Aa, Aa, Ha, Ha, Xyui, Xyui
Qxaz, Qxaz, Qxaz^Bw|, Xyui, Qxaz, Aa, Aa, Aa, Aa^Pog, Aa, Aa^Fpa, Xyui, Xyui
Xyui, Aa, Aa, Qxaz, Qxaz, Aa, Qxaz, Qxaz, Qxaz, Qxaz, Qxaz, Xyui, Xyui
Qxaz, Aa, Aa^Pob, Qxaz, Qxaz, Aa, Qxaz, Aa, Koa, Aa^Pog, Qxaz, Xyui, Xyui
Xyui, Qxaz, Qxaz, Qxaz, Qxaz, Aa, Qxaz, Aa^Pob, Aa, Aa, Qxaz, Xyui, Xyui
Xyui, Xyui, Aa, Qxaz, Aa, Aa, Aa, Qxaz, Qxaz, Qxaz, Qxaz, Xyui, Xyui
Xyui, Xyui, Aa^Fpa, Aa, Aa, Aa, Rra, Aa, Aa, Qxaz, Qxaz, Qxaz, Qxaz
Xyui, Xyui, Xyui, Xyui, Xyui, Rra, 1 Rra, Rra, Xyui, Aa^Pob, Qxaz, Qxaz, Qxaz
Xyui, Xyui, Xyui, Xyui, Xyui, Xyui, Xyui, Xyui, Xyui, Xyui, Xyui, Qxaz, Qxaz
