Xyui, Xyui, Xyui, Xyui, Xyui, Xyui, Xyui, Xyui, Xyui, Xyui, Xyui, Xyui, Xyui
Xyui, Xyui, Xyui, Xyui, Xyui, Xyui, Xyui, Xyui, Xyui, Xyui, Xyui, Xyui, Xyui
Xyui, Xyui, Aa^Aybl, Xyui, Aa, Aa, Aa, Aa, Aa^Esa, Xyui, Aa^Aybl, Xyui, Xyui
Xyui, Xyui, Ha, Ha, Aa, Aa^Esa, Aa, Aa, Aa, Ha, Ha, Xyui, Xyui
Ai, Xyui, Aa^Aybl, Aa, Aa, Aa, Aa^Aybl, Aa, Aa^Esa, Aa, Aa, Aa^Aybl, Xyui
Wwg, Ai, Wwf, Wwf, Ai, Aa^Aybl, Aa^Aybl, Aa^Aybl, Ai, Wwf, Wwf, Wwg, Wwg
Xyui, Wwg, Ai, Wwf, Wwf, Ai, Ai, Ai, Wwf, Wwf, Aa^Aybl, Ai, Ai
Xyui, Xyui, Aa, Ai, Aa^Aybl, Wwf, Wwf, Wwf, Ai, Ai, Aa, Xyui, Xyui
Xyui, Xyui, Ha, Aa, Aa, Aa, Aa, Aa^Aybl, Aa^Esa, Aa, Ha, Xyui, Xyui
Xyui, Xyui, Aa^Aybl, Ha, Aa, Aa, Rra, Aa, Aa, Ha, Aa^Aybl, Xyui, Xyui
Xyui, Xyui, Xyui, Xyui, Xyui, Rra, 1 Rra, Rra, Xyui, Xyui, Xyui, Xyui, Xyui
Xyui, Xyui, Xyui, Xyui, Xyui, Xyui, Xyui, Xyui, Xyui, Xyui, Xyui, Xyui, Xyui
