Xyui, Xyui, Xyui, Xyui, Xyui, Xyui, Xyui, Xyui, Xyui, Xyui, Xyui, Xyui, Xyui
Xyui, Xyui, Xyui, Xyui, Xyui, Xyui, Xyui, Xyui, Xyui, Xyui, Xyui, Xyui, Xyui
Xyui, Xyui, Ai, Aa, Ai, Ai, Aa, Ai, Ai, Aa, Ai, Xyui, Xyui
Xyui, Xyui, Ai, Ai, Xos, Aa, Aa, Aa, Xos, Ai, Ai, Xyui, Xyui
Xyui, Xyui, Ai, Xos, Gs^Ii, Xos, Gd^Ii, Xos, Gs^Ii, Xos, Ai, Xyui, Xyui
Xyui, Xyui, Ai, Xos, Qxu^Ii, Gs^Ii, Gg^Fet, Gs^Ii, Qxu^Ii, Xos, Ai, Xyui, Xyui
Xyui, Xyui, Ai, Aa^Pob, Qxu^Ii, Gs^Ii, Gd^Pog, Gs^Ii, Qxu^Ii, Aa^Pob, Ai, Xyui, Xyui
Xyui, Xyui, Ai, Xos, Gd^Ii, Qxu^Ii, Qxu^Ii, Qxu^Ii, Gd^Ii, Xos, Ai, Xyui, Xyui
Xyui, Xyui, Ha, Aa, Xos, Gs^Ii, Gd^Pog, Gs^Ii, Xos, Aa, Ha, Xyui, Xyui
Xyui, Xyui, Ms, Ha, Ha, Xos, Rra, Xos, Ha, Ha, Ms, Xyui, Xyui
Xyui, Xyui, Xyui, Xyui, Xyui, Rra, 1 Rra, Rra, Xyui, Xyui, Xyui, Xyui, Xyui
Xyui, Xyui, Xyui, Xyui, Xyui, Xyui, Xyui, Xyui, Xyui, Xyui, Xyui, Xyui, Xyui
