Xyui, Xyui, Xyui, Xyui, Xyui, Xyui, Xyui, Xyui, Xyui, Xyui, Xyui, Xyui, Xyui
Xyui, Xyui, Xyui, Xyui, Xyui, Xyui, Xyui, Xyui, Xyui, Xyui, Xyui, Xyui, Xyui
Xyui, Xyui, Aa^Aybl, Ha, Aa, Rra, Rra, Rra, Aa, Xyui, Xyui, Xyui, Xyui
Xyui, Xyui, Ha, Ha, Aa, Rra, Rra, Rra, Aa, Ha, Ha, Xyui, Xyui
Xyui, Xyui, Qxaz, Aa, Xos, Rr, Xos, Aa, Ai, Ha, Ai, Xyui, Xyui
Xyui, Xyui, Qxaz, Xos, Rr, Rr, Rr, Xos, Ai, Ai, Qxaz, Xyui, Xyui
Xyui, Xyui, Qxaz, Xos, Rr, Rb^Ecf, Rr, Rra, Ai, Qxaz, Qxaz, Xyui, Xyui
Xyui, Xyui, Qxaz, Xos, Xos, Rr, Xos, Xos, Ai, Qxaz, Qxaz, Xyui, Xyui
Xyui, Xyui, Ha, Aa, Aa, Re, Aa, Aa, Ai, Ai, Ai, Xyui, Xyui
Xyui, Xyui, Aa^Aybl, Ha, Aa, Re, Rra, Aa, Ai, Ha, Ha, Xyui, Xyui
Xyui, Xyui, Xyui, Ha, Xyui, Rra, 1 Rra, Rra, Xyui, Ha, Xyui, Xyui, Xyui
Xyui, Xyui, Xyui, Xyui, Xyui, Xyui, Xyui, Xyui, Xyui, Xyui, Xyui, Xyui, Xyui
