Xoav, Xoav, Xoav, Xoav, Xoav, Xoav, Xoav, Xoav, Xoav, Xoav, Xoav, Xoav, Xoav
Xoav, Xoav, Xoav, Xoav, Xoav, Xoav, Yhl, Xoav, Xoav, Xoav, Xoav, Xoav, Xoav
Xoav, Xoav, Xoav, Xoav, Yhl, Yhl, Yhl, Yhl, Yhl, Xoav, Xoav, Xoav, Xoav
Xoav, Xoav, Yhl, Yhl, Qxvi, Yhl, Yhl, Yhl, Qxvi, Yhl, Yhl, Xoav, Xoav
Xoav, Xoav, Yhl, Qxvi, Qxvi, Qxvi, Qxvi, Qxvi, Qxvi, Qxvi, Yhl, Xoav, Xoav
Xoav, Xoav, Yhl, Qxvi^Bcv\, Qxvi^Bcv\, Qxvi, Yhl, Qxvi, Qxvi^Bcv/, Qxvi^Bcv/, Yhl, Xoav, Xoav
Xoav, Xoav, Yhl, Qxvi, Qxvi, Yhl, Yhl, Yhl, Qxvi, Qxvi, Yhl, Xoav, Xoav
Xoav, Xoav, Yhl, Qxvi^Bcv\, Yhl, Qxvi, Qxvi^Bcv|, Qxvi, Yhl, Qxvi^Bcv/, Yhl, Xoav, Xoav
Xoav, Xoav, Yhl, Qxvi, Qxvi^Bcv|, Qxvi, Qxvi^Bcv|, Qxvi, Qxvi^Bcv|, Qxvi, Yhl, Xoav, Xoav
Xoav, Xoav, Xoav, Yhl, Yhl, Qxvi, Yhl^Ii, Qxvi, Yhl, Yhl, Xoav, Xoav, Xoav
Xoav, Xoav, Xoav, Xoav, Xoav, Yhl^Ii, 1 Yhl^Ii, Yhl^Ii, Xoav, Xoav, Xoav, Xoav, Xoav
Xoav, Xoav, Xoav, Xoav, Xoav, Xoav, Xoav, Xoav, Xoav, Xoav, Xoav, Xoav, Xoav
