Xoav, Xoav, Xoav, Xoav, Xoav, Xoav, Xoav, Xoav, Xoav, Xoav, Xoav, Xoav, Xoav
Xoav, Xoav, Xoav, Xoav, Xoav, Xoav, Yhl, Xoav, Xoav, Xoav, Yhl, Xoav, Xoav
Xoav, Xoav, Yhl, Yhl, Xoav, Yhl, Yhl, Yhl, Xoav, Yhl, Yhl, Yhl, Xoav
Xoav, Yhl, Yhl, Yhl, Xoav, Yhl, Yhl, Yhl, Qxvi^Bcv/, Yhl, Qxvi, Yhl, Xoav
Xoav, Yhl, Xoav, Yhl, Yhl, Yhl, Yhl, Yhl, Xoav, Qxvi, Qxvi, Qxvi, Qxvi
Xoav, Xoav, Yhl, Yhl, Yhl, Yhl, Xoav, Xoav, Yhl, Yhl, Yhl, Qxvi, Qxvi
Xoav, Yhl, Yhl, Yhl, Xoav, Xoav, Yhl, Yhl, Yhl, Yhl, Yhl, Yhl, Xoav
Xoav, Yhl, Yhl, Xoav, Yhl, Yhl, Yhl, Yhl, Xoav, Xoav, Yhl, Yhl, Xoav
Xoav, Yhl, Yhl, Yhl, Yhl, Yhl, Xoav, Xoav, Yhl, Yhl, Yhl, Yhl, Xoav
Xoav, Xoav, Xoav, Yhl, Xoav, Xoav, Yhl^Ii, Yhl, Yhl, Yhl, Xoav, Xoav, Xoav
Xoav, Xoav, Xoav, Xoav, Xoav, Yhl^Ii, 1 Yhl^Ii, Yhl^Ii, Xoav, Xoav, Xoav, Xoav, Xoav
Xoav, Xoav, Xoav, Xoav, Xoav, Xoav, Xoav, Xoav, Xoav, Xoav, Xoav, Xoav, Xoav
