Xoav, Xoav, Xoav, Xoav, Xoav, Xoav, Xoav, Xoav, Xoav, Xoav, Xoav, Xoav, Xoav
Xoav, Xoav, Xoav, Xoav, Yhl, Yhl, Yhl, Yhl, Yhl, Xoav, Xoav, Xoav, Xoav
Xoav, Xoav, Yhl, Yhl, Xoav, Yhl, Yhl, Yhl, Xoav, Xoav, Yhl, Xoav, Xoav
Xoav, Xoav, Yhl, Yhl, Yhl, Xoav, Xoav, Xoav, Yhl, Yhl, Yhl, Xoav, Xoav
Xoav, Xoav, Yhl, Xoav, Xoav, Yhl, Yhl, Yhl, Xoav, Xoav, Yhl, Xoav, Xoav
Xoav, Xoav, Yhl, Yhl, Xoav, Xoav, Xoav, Xoav, Yhl, Yhl, Yhl, Xoav, Xoav
Xoav, Xoav, Xoav, Xoav, Yhl, Yhl, Yhl, Yhl, Yhl, Xoav, Xoav, Xoav, Xoav
Xoav, Xoav, Yhl, Yhl, Xoav, Yhl, Yhl, Yhl, Xoav, Yhl, Yhl, Xoav, Xoav
Xoav, Xoav, Yhl, Yhl, Yhl, Xoav, Xoav, Xoav, Yhl, Yhl, Yhl, Xoav, Xoav
Xoav, Xoav, Xoav, Yhl, Yhl, Yhl, Yhl^Ii, Xoav, Xoav, Yhl, Xoav, Xoav, Xoav
Xoav, Xoav, Xoav, Xoav, Xoav, Yhl^Ii, 1 Yhl^Ii, Yhl^Ii, Xoav, Xoav, Xoav, Xoav, Xoav
Xoav, Xoav, Xoav, Xoav, Xoav, Xoav, Xoav, Xoav, Xoav, Xoav, Xoav, Xoav, Xoav
