Xoav, Xoav, Xoav, Xoav, Xoav, Xoav, Xoav, Xoav, Xoav, Xoav, Xoav, Xoav, Xoav
Xoav, Xoav, Xoav, Xoav, Yhl, Xoav, Yhl, Xoav, Yhl, Xoav, Xoav, Xoav, Xoav
Xoav, Xoav, Yhl, Yhl, Yhl, Yhl, Yhl, Yhl, Yhl, Yhl, Yhl, Xoav, Xoav
Xoav, Qxvi, Yhl, Yhl, Yhl, Yhl, Yhl, Yhl, Yhl, Yhl, Yhl, Qxvi, Xoav
Xoav, Yhl, Yhl, Yhl, Yhl, Qxvi, Qxvi, Qxvi, Yhl, Yhl, Yhl, Yhl, Xoav
Xoav, Yhl, Yhl, Yhl, Yhl, Qxvi^Bsv\, Yhl, Qxvi^Bsv/, Yhl, Yhl, Yhl, Yhl, Xoav
Xoav, Yhl, Yhl, Yhl, Yhl, Qxvi, Yhl, Qxvi, Yhl, Yhl, Yhl, Yhl, Xoav
Xoav, Yhl, Yhl, Yhl, Yhl, Qxvi, Yhl, Qxvi, Yhl, Yhl, Yhl, Yhl, Xoav
Xoav, Yhl, Yhl, Yhl, Yhl, Qxvi^Bsv/, Qxvi, Qxvi^Bsv\, Yhl, Yhl, Yhl, Yhl, Xoav
Xoav, Qxvi, Yhl, Yhl, Yhl, Qxvi, Yhl^Ii, Qxvi, Yhl, Yhl, Yhl, Qxvi, Xoav
Xoav, Xoav, Xoav, Yhl, Yhl, Yhl^Ii, 1 Yhl^Ii, Yhl^Ii, Yhl, Yhl, Xoav, Xoav, Xoav
Xoav, Xoav, Xoav, Xoav, Xoav, Xoav, Xoav, Xoav, Xoav, Xoav, Xoav, Xoav, Xoav
