Xoav, Xoav, Xoav, Xoav, Xoav, Xoav, Xoav, Xoav, Xoav, Xoav, Xoav, Xoav, Xoav
Xoav, Xoav, Xoav, Xoav, Xoav, Xoav, Yhl, Xoav, Xoav, Xoav, Xoav, Xoav, Xoav
Xoav, Xoav, Xoav, Xoav, Yhl, Yhl, Yhl, Yhl, Yhl, Xoav, Xoav, Xoav, Xoav
Xoav, Xoav, Yhl, Yhl, Yhl, Yhl, Yhl, Yhl, Yhl, Yhl, Yhl, Xoav, Xoav
Xoav, Xoav, Yhl, Yhl^Pop, Yhl, Yhl, Xoav, Yhl, Yhl, Yhl^Por, Yhl, Xoav, Xoav
Xoav, Xoav, Xoav, Yhl, Qxvi, Yhl, Xoav, Yhl, Qxvi, Yhl, Xoav, Xoav, Xoav
Xoav, Xoav, Yhl, Xoav, Qxvi, Qxvi, Xoav, Qxvi, Qxvi, Xoav, Yhl, Xoav, Xoav
Xoav, Xoav, Yhl, Yhl, Yhl, Qxvi, Xoav, Qxvi, Yhl, Yhl, Yhl, Xoav, Xoav
Xoav, Xoav, Yhl, Yhl^Pop, Yhl, Yhl, Xoav, Yhl, Yhl, Yhl^Por, Yhl, Xoav, Xoav
Xoav, Xoav, Xoav, Yhl, Yhl, Yhl, Yhl^Ii, Yhl, Yhl, Yhl, Xoav, Xoav, Xoav
Xoav, Xoav, Xoav, Xoav, Xoav, Yhl^Ii, 1 Yhl^Ii, Yhl^Ii, Xoav, Xoav, Xoav, Xoav, Xoav
Xoav, Xoav, Xoav, Xoav, Xoav, Xoav, Xoav, Xoav, Xoav, Xoav, Xoav, Xoav, Xoav
