Xoav, Xoav, Xoav, Xoav, Xoav, Xoav, Xoav, Xoav, Xoav, Xoav, Xoav, Xoav, Xoav
Xoav, Xoav, Xoav, Xoav, Xoav, Xoav, Yhl, Xoav, Xoav, Xoav, Xoav, Xoav, Xoav
Xoav, Xoav, Xoav, Xoav, Yhl, Yhl, Yhl, Yhl, Yhl, Xoav, Xoav, Xoav, Xoav
Xoav, Xoav, Yhl, Yhl, Yhl, Yhl, Yhl, Yhl, Yhl, Yhl, Yhl, Xoav, Xoav
Xoav, Xoav, Yhl, Yhl^Pob, Yhl, Yhl, Xoav, Yhl, Yhl, Yhl^Por, Yhl, Xoav, Xoav
Xoav, Xoav, Yhl, Yhl, Yhl, Qxvi, Xoav, Qxvi, Yhl, Yhl, Yhl, Xoav, Xoav
Xoav, Xoav, Yhl, Yhl^Pop, Yhl, Qxvi, Xoav, Qxvi, Yhl, Yhl^Pop, Yhl, Xoav, Xoav
Xoav, Xoav, Yhl, Yhl, Yhl, Qxvi, Xoav, Qxvi, Yhl, Yhl, Yhl, Xoav, Xoav
Xoav, Xoav, Yhl, Yhl^Por, Yhl, Qxvi, Xoav, Qxvi, Yhl, Yhl^Pob, Yhl, Xoav, Xoav
Xoav, Xoav, Xoav, Yhl, Yhl, Yhl, Yhl^Ii, Yhl, Yhl, Yhl, Xoav, Xoav, Xoav
Xoav, Xoav, Xoav, Xoav, Xoav, Yhl^Ii, 1 Yhl^Ii, Yhl^Ii, Xoav, Xoav, Xoav, Xoav, Xoav
Xoav, Xoav, Xoav, Xoav, Xoav, Xoav, Xoav, Xoav, Xoav, Xoav, Xoav, Xoav, Xoav
