Xoav, Xoav, Xoav, Xoav, Xoav, Xoav, Xoav, Xoav, Xoav, Xoav, Xoav, Xoav, Xoav
Xoav, Xoav, Xoav, Xoav, Xoav, Xoav, Yhl, Xoav, Xoav, Xoav, Xoav, Xoav, Xoav
Xoav, Xoav, Xoav, Xoav, Yhl, Yhl, Yhl, Yhl, Yhl, Xoav, Xoav, Xoav, Xoav
Xoav, Xoav, Qxvi, Yhl, Yhl, Yhl, Yhl, Yhl, Yhl^Pop, Yhl, Yhl, Xoav, Qxvi
Xoav, Xoav, Yhl, Qxvi^Bsv/, Qxvi, Yhl, Yhl, Yhl, Yhl, Yhl, Qxvi^Bsv|, Qxvi, Qxvi
Xoav, Xoav, Yhl, Yhl, Yhl, Qxvi, Yhl, Yhl, Qxvi, Qxvi, Qxvi^Bsv|, Qxvi, Xoav
Xoav, Xoav, Yhl, Yhl^Pop, Yhl, Qxvi, Qxvi^Bsv|, Qxvi, Qxvi, Qxvi, Yhl, Xoav, Xoav
Xoav, Xoav, Yhl, Yhl, Qxvi, Qxvi, Qxvi^Bsv|, Qxvi, Yhl, Yhl, Yhl, Xoav, Xoav
Xoav, Xoav, Qxvi, Qxvi, Qxvi, Qxvi, Yhl, Yhl, Yhl, Yhl, Yhl, Xoav, Xoav
Qxvi, Qxvi, Qxvi, Qxvi, Yhl, Yhl, Yhl^Ii, Yhl, Yhl, Yhl, Xoav, Xoav, Xoav
Qxvi, Qxvi, Xoav, Xoav, Xoav, Yhl^Ii, 1 Yhl^Ii, Yhl^Ii, Xoav, Xoav, Xoav, Xoav, Xoav
Xoav, Xoav, Xoav, Xoav, Xoav, Xoav, Xoav, Xoav, Xoav, Xoav, Xoav, Xoav, Xoav
