Qxvi, Qxvi, Qxvi, Qxvi, Qxvi, Qxvi, Qxvi, Qxvi, Qxvi, Qxvi, Qxvi, Qxvi, Qxvi
Qxvi, Yhl, Yhl, Qxvi, Qxvi, Qxvi, Yhl, Qxvi, Qxvi, Qxvi, Yhl, Yhl, Qxvi
Qxvi, Yhl, Yhl, Qxvi, Qxvi, Yhl, Yhl, Yhl, Qxvi, Qxvi, Yhl, Yhl, Qxvi
Qxvi, Yhl, Qxvi^Bcv|, Qxvi, Qxvi, Yhl, Yhl, Yhl, Qxvi, Qxvi, Qxvi^Bcv|, Yhl, Qxvi
Qxvi, Qxvi, Qxvi^Bcv|, Qxvi, Qxvi^Bcv/, Qxvi^Bcv/, Qxvi, Qxvi^Bcv\, Qxvi^Bcv\, Qxvi, Qxvi^Bcv|, Qxvi, Qxvi
Qxvi, Qxvi, Yhl, Yhl, Yhl, Qxvi, Qxvi, Qxvi, Yhl, Yhl, Yhl, Qxvi, Qxvi
Qxvi, Qxvi, Qxvi^Bcv|, Yhl, Qxvi, Qxvi, Xoav, Qxvi, Qxvi, Yhl, Qxvi^Bcv|, Qxvi, Qxvi
Qxvi, Qxvi, Qxvi^Bcv|, Qxvi, Qxvi, Xoav, Yhl, Xoav, Qxvi, Qxvi, Qxvi^Bcv|, Qxvi, Qxvi
Qxvi, Qxvi, Yhl, Qxvi, Qxvi, Qxvi, Qxvi^Bcv|, Qxvi, Qxvi, Qxvi, Yhl, Qxvi, Qxvi
Qxvi, Yhl, Yhl, Qxvi^Bcv\, Qxvi^Bcv\, Qxvi, Yhl^Ii, Qxvi, Qxvi^Bcv/, Qxvi^Bcv/, Yhl, Yhl, Qxvi
Qxvi, Qxvi, Qxvi, Qxvi, Qxvi, Yhl^Ii, 1 Yhl^Ii, Yhl^Ii, Qxvi, Qxvi, Qxvi, Qxvi, Qxvi
Qxvi, Qxvi, Qxvi, Qxvi, Qxvi, Qxvi, Qxvi, Qxvi, Qxvi, Qxvi, Qxvi, Qxvi, Qxvi
