Qxvi, Qxvi, Qxvi, Qxvi, Qxvi, Qxvi, Qxvi, Qxvi, Qxvi, Qxvi, Qxvi, Qxvi, Qxvi
Qxvi, Yhl, Yhl, Qxvi, Qxvi, Qxvi, Yhl, Qxvi, Qxvi, Qxvi, Yhl, Yhl, Qxvi
Qxvi, Yhl, Yhl, Qxvi, Qxvi, Yhl, Yhl, Yhl, Qxvi, Qxvi, Yhl, Yhl, Qxvi
Qxvi, Yhl, Qxvi^Bcv|, Qxvi, Qxvi, Yhl, Yhl, Yhl, Qxvi, Qxvi, Qxvi^Bcv|, Yhl, Qxvi
Qxvi, Qxvi, Qxvi^Bcv|, Qxvi, Qxvi^Bcv/, Qxvi^Bcv/, Qxvi, Qxvi^Bcv\, Qxvi^Bcv\, Qxvi, Qxvi^Bcv|, Qxvi, Qxvi
Qxvi, Qxvi, Yhl, Yhl, Yhl, Qxvi, Qxvi, Qxvi, Yhl, Yhl, Yhl, Qxvi, Qxvi
Qxvi, Qxvi, Qxvi^Bcv|, Yhl, Qxvi, Qxvi^Bcv\, Yhl, Qxvi^Bcv/, Qxvi, Yhl, Qxvi^Bcv|, Qxvi, Qxvi
Qxvi, Qxvi, Qxvi^Bcv|, Qxvi, Xoav, Xoav, Yhl, Xoav, Xoav, Qxvi, Qxvi^Bcv|, Qxvi, Qxvi
Qxvi, Qxvi, Yhl, Qxvi, Yhl, Yhl, Yhl, Yhl, Yhl, Qxvi, Yhl, Qxvi, Qxvi
Qxvi, Yhl, Yhl, Qxvi^Bcv\, Yhl, Yhl, Yhl^Ii, Yhl, Yhl, Qxvi^Bcv/, Yhl, Yhl, Qxvi
Qxvi, Qxvi, Qxvi, Qxvi, Yhl, Yhl^Ii, 1 Yhl^Ii, Yhl^Ii, Yhl, Qxvi, Qxvi, Qxvi, Qxvi
Qxvi, Qxvi, Qxvi, Qxvi, Qxvi, Qxvi, Qxvi, Qxvi, Qxvi, Qxvi, Qxvi, Qxvi, Qxvi
