Xoav, Xoav, Xoav, Xoav, Xoav, Xoav, Xoav, Xoav, Xoav, Xoav, Xoav, Xoav, Xoav
Xoav, Xoav, Xoav, Xoav, Yhl, Xoav, Yhl, Xoav, Yhl, Xoav, Xoav, Xoav, Xoav
Xoav, Xoav, Yhl, Yhl, Yhl, Yhl, Yhl, Yhl, Yhl, Yhl, Yhl, Xoav, Xoav
Xoav, Qxvi, Yhl, Yhl, Xoav, Yhl, Yhl, Yhl, Xoav, Yhl, Yhl, Qxvi, Xoav
Xoav, Qxvi, Yhl, Yhl, Yhl, Yhl, Yhl, Yhl, Yhl, Yhl, Yhl, Qxvi, Xoav
Xoav, Qxvi, Yhl, Yhl^Pop, Yhl, Yhl, Yhl, Yhl, Yhl, Yhl^Pop, Yhl, Qxvi, Xoav
Xoav, Qxvi, Yhl, Yhl, Yhl, Yhl, Yhl, Yhl, Yhl, Yhl, Yhl, Qxvi, Xoav
Xoav, Qxvi, Yhl, Yhl, Xoav, Yhl, Yhl, Yhl, Xoav, Yhl, Yhl, Qxvi, Xoav
Xoav, Qxvi, Yhl, Yhl, Yhl, Yhl, Yhl, Yhl, Yhl, Yhl, Yhl, Qxvi, Xoav
Xoav, Qxvi, Yhl, Yhl, Yhl, Yhl, Yhl^Ii, Yhl, Yhl, Yhl, Yhl, Qxvi, Xoav
Xoav, Xoav, Xoav, Yhl, Yhl, Yhl^Ii, 1 Yhl^Ii, Yhl^Ii, Yhl, Yhl, Xoav, Xoav, Xoav
Xoav, Xoav, Xoav, Xoav, Xoav, Xoav, Xoav, Xoav, Xoav, Xoav, Xoav, Xoav, Xoav
