Xue, Xue, Xue, Xue, Xue, Xue, Xue, Xue, Xue, Xue, Xue, Xue, Xue
Xue, Xue, Xue, Xue, Xue, Xue, Dd, Xue, Xue, Xue, Xue, Xue, Xue
Xue, Xue, Xue, Xue, Dd^Ftd, Dd^Ftd, Rd, Dd^Ftd, Dd^Ftd, Xue, Xue, Xue, Xue
Xue, Xue, Dd^Ftd, Dd^Ftd, Kdr, Cdr, Rd, Cdr, Kdr, Dd^Ftd, Dd^Ftd, Xue, Xue
Xue, Xue, Dd^Vdr, Dd, Dd^Esd, Dd, Rd, Dd, Dd^Esd, Dd, Dd^Vdr, Xue, Xue
Xue, Xue, Rd, Dd^Esd, Rd^Esd, Rd, Qxe, Rd, Rd^Esd, Dd^Esd, Rd, Xue, Xue
Xue, Xue, Cdr, Rd, Dd^Vdr, Qxe, Qxe, Qxe, Dd^Vdr, Rd, Cdr, Xue, Xue
Xue, Xue, Dd, Rd, Rd, Qxe, Qxe, Qxe, Rd, Rd, Dd, Xue, Xue
Xue, Xue, Qxe, Dd, Dd^Edpp, Rd, Rd, Rd^Esd, Dd, Dd, Qxe, Xue, Xue
Xue, Xue, Xue, Dd, Dd, Dd, Rd^Esd, Dd, Dd, Dd^Edpp, Xue, Xue, Xue
Xue, Xue, Xue, Xue, Xue, Rd^Esd, 1 Rd, Rd, Xue, Xue, Xue, Xue, Xue
Xue, Xue, Xue, Xue, Xue, Xue, Xue, Xue, Xue, Xue, Xue, Xue, Xue
