Xue, Xue, Xue, Xue, Xue, Xue, Xue, Xue, Xue, Xue, Xue, Xue, Xue
Xue, Xue, Xue, Xue, Xue, Xue, Xue, Xue, Xue, Xue, Xue, Xue, Xue
Xue, Xue, Xue, Xue, Dd, Dd^Edpp, Dd, Dd, Dd, Xue, Xue, Xue, Xue
Xue, Xue, Qxe, Xue, Dd^Edp, Dd, Dd, Dd^Edp, Dd, Xue, Qxe, Xue, Xue
Xue, Xue, Qxe, Dd, Dd, Dd, Gs, Dd, Dd, Dd, Qxe, Xue, Xue
Xue, Xue, Xue, Dd, Gs^Edpp, Gs^Fts, Wwt, Gs^Fts, Gs^Edpp, Dd, Xue, Xue, Xue
Xue, Xue, Dd^Edp, Dd, Gs, Wwt, Wwt, Wwt, Gs^Edpp, Dd, Dd, Xue, Xue
Qxe, Qxe, Qxe, Dd, Dd, Gs^Fts, Gs, Gs^Fts, Dd, Dd, Qxe, Qxe, Qxe
Qxe, Qxe, Qxe, Dd, Dd, Gd, Gd^Fts, Gd, Dd, Dd^Edp, Qxe, Qxe, Qxe
Xue, Qxe, Qxe, Qxe, Dd, Gd, Ds, Gd, Dd, Qxe, Qxe, Qxe, Xue
Xue, Xue, Xue, Xue, Xue, Ds, 1 Ds, Ds, Xue, Xue, Xue, Xue, Xue
Xue, Xue, Xue, Xue, Xue, Xue, Xue, Xue, Xue, Xue, Xue, Xue, Xue
