Xue, Xue, Xue, Xue, Xue, Xue, Xue, Xue, Xue, Xue, Xue, Xue, Xue
Xue, Xue, Xue, Xue, Dd, Dd, Dd, Dd, Dd^Edpp, Xue, Xue, Xue, Xue
Xue, Xue, Dd, Dd, Gd^Fts, Dd, Dd, Dd, Dd, Dd^Esd, Dd^Esd, Xue, Xue
Xue, Xue, Dd, Dd, Wwt, Gd^Fts, Wwt, Dd, Dd^Edpp, Xue, Dd^Esd, Xue, Xue
Dd, Xue, Dd, Wwf, Gd, Wwt, Gs^Efm, Gd, Gd, Dd, Dd, Xue, Dd
Rd, Dd, Rd, Dd, Rd, Gs^Efm, Cd^Fet, Gs^Efm, Rd, Rd, Rd, Rd, Rd
Dd, Rd, Dd, Rd, Gd, Gs^Efm, Gs^Efm, Gs^Efm, Gd, Dd, Dd, Dd, Dd
Xue, Xue, Dd^Esd, Dd, Dd^Edpp, Gd, Wwt, Wwt, Wwt, Wwf, Dd, Xue, Xue
Xue, Xue, Dd^Esd, Xue, Dd, Dd, Dd, Gd^Fts, Gd^Fts, Dd, Dd, Xue, Xue
Xue, Xue, Xue, Dd^Esd, Dd^Edpp, Dd, Ur^Ii, Dd, Dd, Dd, Xue, Xue, Xue
Xue, Xue, Xue, Xue, Xue, Ur^Ii, 1 Ur^Ii, Ur^Ii, Xue, Xue, Xue, Xue, Xue
Xue, Xue, Xue, Xue, Xue, Xue, Xue, Xue, Xue, Xue, Xue, Xue, Xue
