Gll^Fdw, Gll, Gll^Fdw, Gll^Fdw, Hhd^Fdw, Gg, Md^Fdw, Hhd, Hhd, Gll^Fdw, Gll^Fdw, Gll^Fdw, Gll^Fdw
Gll^Fdw, Gll^Fdw, Hhd^Fdw, Hhd^Fdw, Md^Feth, Md^Fdw, Xoa, Md^Fdw, Md^Feth, Hhd^Fdw, Hhd^Fdw, Gll^Fdw, Gll^Fdw
Gll^Fdw, Hhd^Fdw, Md^Fdw, Md^Fdw, Md^Fdw, Xoa, Urb, Xoa, Md^Fdw, Md^Fdw, Md^Fdw, Hhd^Fdw, Gll^Fdw
Gll^Fdw, Hhd^Fdw, Hhd^Fdw, Md^Fdw, Hhd^Fdw, Xoa^Efs, Rb, Xoa^Efs, Hhd^Fdw, Md^Fdw, Hhd^Fdw, Hhd^Fdw, Gll^Fdw
Gll^Fdw, Gll^Fdw, Gll^Fdw, Hhd^Fdw, Gll^Feth, Gll, Rb, Gll, Gll^Feth, Hhd^Fdw, Gll^Fdw, Gll^Fdw, Gll^Fdw
Gll^Fdw, Gll^Fdw, Gll^Fdw, Gll^Fdw, Gll, Gll, Rb, Gll, Gll, Gll^Fdw, Gll^Fdw, Gll^Fdw, Gll^Fdw
Gll^Fdw, Gll^Fdw, Gll^Fmw, Gll^Fmw, Gll, Gll, Rb, Gll, Gll, Gll^Fmw, Gll^Fmw, Gll^Fdw, Gll^Fdw
Gs^Fms, Gll^Fmw, Gs^Fms, Gs^Fms, Gd, Gd, Re, Gd, Gd, Gs^Fms, Ce, Gll^Fmw, Gs^Fms
Gs^Fms, Gs^Fms, Gs^Fms, Gs^Fms, Gs, Gs, Re, Gs, Re, Re, Gs^Fms, Gs^Fms, Gs^Fms
Gs^Fms, Gs^Fms, Gg, Gg, Gg, Gg, Re, Re, Gg, Gg, Gg, Gs^Fms, Gs^Fms
Gg, Gg, Gg, Gg, Gg, Gg, 1 Re, Gg, Gg, Gg, Gg, Gg, Gg
Gg, Gg, Gg, Gg, Gg, Gg, Gg, Gg, Gg, Gg, Gg, Gg, Gg
