Xom, Xom, Xom, Xom, Xom, Xom, Xom, Xom, Xom, Xom, Xom, Xom, Xom
Xom, Xom, Xom, Xom, Xom, Xom, Iwr, Xom, Xom, Xom, Xom, Xom, Xom
Xom, Xom, Xom, Xom, Iwr, Iwr, Iwr, Iwr, Iwr, Xom, Xom, Xom, Xom
Xom, Xom, Iwr, Iwr, Iwr, Iwr, Re, Iwr, Iwr, Iwr, Iwr, Xom, Xom
Xom, Xom, Iwr, Iwr, Re, Re, Wo, Re, Re, Iwr, Iwr, Xom, Xom
Xom, Xom, Iwr, Iwr, Re, Wo, Re, Wo, Re, Iwr, Iwr, Xom, Xom
Xom, Xom, Iwr, Iwr, Re, Wo, Wo, Wo, Re, Iwr, Iwr, Xom, Xom
Xom, Xom, Iwr, Iwr, Iwr, Re, Re, Re, Iwr, Iwr, Iwr, Xom, Xom
Xom, Xom, Iwr, Iwr, Iwr, Iwr, Iwr, Iwr, Iwr, Iwr, Iwr, Xom, Xom
Xom, Xom, Xom, Iwr, Iwr, Iwr, Ur^Ii, Iwr, Iwr, Iwr, Xom, Xom, Xom
Xom, Xom, Xom, Xom, Xom, Ur^Ii, 1 Ur^Ii, Ur^Ii, Xom, Rr^Pw/, Iwr, Xom, Xom
Xom, Xom, Xom, Xom, Xom, Xom, Xom, Xom, Xom, Xom, Xom, Xom, Xom
