Xom, Xom, Xom, Xom, Xom, Xom, Xom, Xom, Xom, Xom, Xom, Xom, Xom
Xom, Xom, Xom, Xom, Xom, Xom, Iwr, Xom, Xom, Xom, Xom, Xom, Xom
Xom, Xom, Xom, Xom, Xom, Iwr, Iwr, Iwr, Xom, Xom, Xom, Xom, Xom
Xom, Xom, Xom, Xom, Xom, Iwr, Iwr, Iwr, Xom, Xom, Xom, Xom, Xom
Xom, Xom, Iwr, Iwr, Iwr, Xom, Iwr, Xom, Iwr, Iwr, Iwr, Xom, Xom
Xom, Xom, Iwr, Iwr, Iwr, Iwr, Iwr, Iwr, Iwr, Iwr, Iwr, Xom, Xom
Xom, Xom, Iwr, Iwr, Iwr, Iwr, Iwr, Iwr, Iwr, Iwr, Iwr, Xom, Xom
Xom, Xom, Iwr, Iwr, Iwr, Iwr, Iwr, Iwr, Iwr, Iwr, Iwr, Xom, Xom
Xom, Xom, Iwr, Iwr, Iwr, Iwr, Iwr, Iwr, Iwr, Iwr, Iwr, Xom, Xom
Xom, Xom, Xom, Iwr, Iwr, Iwr, Ur^Ii, Iwr, Iwr, Iwr, Xom, Xom, Xom
Xom, Xom, Xom, Xom, Xom, Ur^Ii, 1 Ur^Ii, Ur^Ii, Xom, Rr^Pw/, Iwr, Xom, Xom
Xom, Xom, Xom, Xom, Xom, Xom, Xom, Xom, Xom, Xom, Xom, Xom, Xom
