Xom, Xom, Xom, Xom, Xom, Xom, Xom, Xom, Xom, Xom, Xom, Xom, Xom
Xom, Xom, Xom, Xom, Xom, Xom, Iwr, Xom, Xom, Xom, Xom, Xom, Xom
Xom, Xom, Xom, Xom, Iwr, Iwr, Iwr, Iwr, Iwr, Xom, Xom, Xom, Xom
Xom, Xom, Iwr, Iwr, Iwr, Iwr, Iwr, Iwr, Iwr, Iwr, Iwr, Xom, Xom
Iwr, Xom, Iwr, Iwr, Iwr, Iwr, Iwr, Iwr, Iwr, Iwr, Iwr, Xom, Iwr
Wo, Iwr, Iwr, Iwr, Iwr, Iwr, Iwr, Iwr, Iwr, Iwr, Iwr, Iwr, Wo
Xom, Wo, Wo, Iwr, Wo, Iwr, Wo, Iwr, Wo, Iwr, Wo, Wo, Xom
Xom, Xom, Iwr, Wo, Iwr, Wo, Iwr, Wo, Iwr, Wo, Iwr, Xom, Xom
Xom, Xom, Iwr, Iwr, Iwr, Iwr, Iwr, Iwr, Iwr, Iwr, Iwr, Xom, Xom
Xom, Xom, Xom, Iwr, Iwr, Iwr, Ur^Ii, Iwr, Iwr, Iwr, Xom, Xom, Xom
Xom, Xom, Xom, Xom, Xom, Ur^Ii, 1 Ur^Ii, Ur^Ii, Xom, Rr^Pw/, Iwr, Xom, Xom
Xom, Xom, Xom, Xom, Xom, Xom, Xom, Xom, Xom, Xom, Xom, Xom, Xom
