Xoa, Xoa, Xoa, Xoa, Xoa, Xoa, Uu, Xoa, Xoa, Xoa, Xoa, Xoa, Xoa
Xoa, Xoa, Xoa, Xoa, Uu^Ebn, Uu, Uu, Uu, Uu^Ebn, Xoa, Xoa, Xoa, Xoa
Xoa, Xoa, Uu^Emf, Uu^Vud, Ur, Uu, Uu, Uu, Ur, Uu^Vud, Uu^Emf, Xoa, Xoa
Xoa, Uu^Vud, Ur, Uu^Emf, Cud, Ur, Ur, Ur, Cud, Uu^Emf, Ur, Uu^Vud, Xoa
Xoa, Uu^Emf, Uu^Emf, Ur, Ur, Ur, Cud, Ur, Ur, Ur, Uu^Emf, Uu^Emf, Xoa
Xoa, Uu^Vud, Ur, Cud, Ur^Ebn, Cud, Kud^Ii, Cud, Ur^Ebn, Cud, Ur, Uu^Vud, Xoa
Xoa, Uu^Emf, Uu^Emf, Ur, Ur, Cud, Cud, Cud, Ur, Ur, Uu^Emf, Uu^Emf, Xoa
Xoa, Uu^Emf, Ur, Ur, Ur, Ur, Ur, Ur, Ur, Ur, Ur, Uu^Emf, Xoa
Xoa, Uu^Vud, Uu^Emf, Uu^Emf, Ur, Cud, Ur, Cud, Ur, Uu^Emf, Uu^Emf, Uu^Vud, Xoa
Xoa, Xoa, Xoa, Uu^Vud, Ur, Ur, Ur^Ii, Ur, Ur, Uu^Vud, Xoa, Xoa, Xoa
Xoa, Xoa, Xoa, Xoa, Xoa, Ur^Ii, 1 Ur^Ii, Ur^Ii, Xoa, Xoa, Xoa, Xoa, Xoa
Xoa, Xoa, Xoa, Xoa, Xoa, Xoa, Urb, Xoa, Xoa, Xoa, Xoa, Xoa, Xoa
