Xoa, Xoa, Xoa, Xoa, Xoa, Xoa, Xoa, Xoa, Xoa, Xoa, Xoa, Xoa, Xoa
Xoa, Xoa, Xoa, Xoa, Xoa, Xoa, Isa, Xoa, Xur, Xoa, Xoa, Xoa, Xoa
Xoa, Xoa, Xoa, Xur, Isa, Isa, Isa, Isa, Isa, Xoa, Xoa, Xoa, Xoa
Xoa, Xur, Isa, Isa, Isa, Isa, Isa, Isa, Isa, Isa, Isa, Xoa, Xoa
Xoa, Xoa, Isa, Exos, Isa, Isa, Isa^Ii, Isa, Isa, Xoa, Isa, Xoa, Xoa
Xoa, Xoa, Isa, Isa, Isa, Isa^Ii, Isa^Ii, Isa^Ii, Isa, Isa, Isa, Xoa, Xoa
Xoa, Xoa, Isa, Isa, Isa, Isa^Ii, Isa^Ii, Isa^Ii, Isa, Isa, Isa, Xur, Xoa
Xoa, Xur, Isa, Isa, Isa, Isa, Isa, Isa, Isa, Isa, Isa, Xur, Xoa
Xoa, Xoa, Isa, Xoa, Isa, Isa, Isa, Isa, Isa, Exos, Isa, Xur, Xoa
Xoa, Xoa, Xur, Isa, Isa, Isa, Isa^Ii, Isa, Isa, Isa, Xoa, Xoa, Xoa
Xoa, Xoa, Xoa, Xoa, Xoa, Isa^Ii, 1 Isa^Ii, Isa^Ii, Xoa, Xur, Xoa, Xoa, Xoa
Xoa, Xoa, Xoa, Xoa, Xoa, Xoa, Xoa, Xoa, Xoa, Xoa, Xoa, Xoa, Xoa
