Xoa, Xoa, Xoa, Xoa, Xoa, Xoa, Xoa, Xoa, Xoa, Xoa, Xoa, Xoa, Xoa
Xoa, Xoa, Xoa, Xoa, Xoa^Efs, Xoa, Isa, Xoa, Xoa^Efs, Xoa, Xoa, Xoa, Xoa
Xoa, Xoa, Xur, Xoa, Isa, Isa, Isa, Isa, Isa, Xoa, Xur, Xoa, Xoa
Xoa, Xoa, Isa, Isa, Exos, Isa, Isa, Isa, Xoa, Isa, Isa, Xoa, Xoa
Xoa, Xoa, Isa, Isa^Pob, Isa, Isa, Isa, Isa, Isa^Br/, Isa^Por, Isa, Xoa, Xoa
Xoa, Xur, Isa, Isa^Br|, Isa^Br\, Isa, Isa^Br/, Isa^Dr, Isa, Isa, Isa, Xoa, Xoa
Xoa, Xoa, Isa, Isa, Isa, Isa^Br\, Isa^Br\, Isa^Maus, Isa, Isa, Isa, Xur, Xoa
Xoa, Xoa, Isa, Isa, Isa^Br/, Isa^Br/, Isa, Isa^Br\, Isa^Br\, Isa, Isa, Xoa, Xoa
Xoa, Xoa, Isa, Isa^Por, Exos^Eb, Isa, Isa, Isa, Exos^Ebn, Isa^Pob, Isa, Xoa, Xoa
Xoa, Xoa, Xur, Isa, Isa, Isa, Ur^Ii, Isa, Isa, Isa, Xur, Xoa, Xoa
Xoa, Xoa, Xoa, Xur, Xoa, Ur^Ii, 1 Ur^Ii, Ur^Ii, Xoa, Xoa, Xoa, Xoa, Xoa
Xoa, Xoa, Xoa, Xoa, Xoa, Xoa, Xoa, Xoa, Xoa, Xoa, Xoa, Xoa, Xoa
