Xof, Xof, Xof, Xof, Xof, Xof, Xof, Xof, Xof, Xof, Xof, Xof, Xof
Xof, Xof, Xof, Xof, Xof, Xof, Gs, Xof, Xof, Xof, Xof, Xof, Xof
Xof, Xof, Xof, Xof, Gg^Efm, Gs, Gs, Gs, Gg^Efm, Xof, Xof, Xof, Xof
Xof, Xof, Gs^Fds, Gs^Fds, Gg^Efm, Gs, Gs, Gs, Gg^Efm, Gs^Fds, Gs^Fds, Xof, Xof
Xof, Xof, Gs^Fds, Gg^Fet, Gg^Efm, Gg^Efm, Gg^Efm, Gg^Efm, Gg^Efm, Gg^Fet, Gs^Fds, Xof, Xof
Xof, Xof, Gg^Efm, Gg^Efm, Gg^Efm, Gg^Efm, Wwt, Gg^Efm, Gg^Efm, Gg^Efm, Gg^Efm, Xof, Xof
Xof, Xof, Gg^Efm, Gg^Pob, Gg^Efm, Wwt, Cv, Wwt, Gg^Efm, Gg^Pob, Gg^Efm, Xof, Xof
Xof, Xof, Gs^Fds, Gg^Efm, Gg^Efm, Gg^Efm, Gs, Gg^Efm, Gg^Efm, Gg^Efm, Gs^Fds, Xof, Xof
Xof, Xof, Gs^Fds, Gg^Fet, Gg^Efm, Gg^Efm, Gs, Gg^Efm, Gg^Efm, Gg^Fet, Gs^Fds, Xof, Xof
Xof, Xof, Xof, Gs^Fds, Gg, Gg, Gs^Ii, Gg, Gg, Gs^Fds, Xof, Xof, Xof
Xof, Xof, Xof, Xof, Xof, Gs^Ii, 1 Gs^Ii, Gs^Ii, Xof, Xof, Xof, Xof, Xof
Xof, Xof, Xof, Xof, Xof, Xof, Xof, Xof, Xof, Xof, Xof, Xof, Xof
