Qxvi, Qxvi, Qxvi, Qxvi, Qxvi, Qxvi, Qxvi, Qxvi, Qxvi, Qxvi, Qxvi, Qxvi, Qxvi
Qxvi, Qxvi, Qxvi, Qxvi, Qxvi, Qxvi, Yhl, Qxvi, Qxvi, Qxvi, Qxvi, Qxvi, Qxvi
Qxvi, Qxvi, Yhl, Qxvi, Qxvi^Bcv/, Yhl, Yhl, Yhl, Qxvi^Bcv\, Qxvi, Yhl, Qxvi, Qxvi
Qxvi, Yhl, Xoav, Yhl, Qxvi, Yhl, Yhl, Yhl, Qxvi, Yhl, Xoav, Yhl, Qxvi
Qxvi, Yhl, Yhl, Yhl, Yhl, Qxvi, Qxvi^Bcv|, Qxvi, Yhl, Yhl, Yhl, Yhl, Qxvi
Qxvi, Qxvi, Yhl, Yhl, Xoav, Yhl, Yhl, Yhl, Xoav, Yhl, Yhl, Qxvi, Qxvi
Qxvi, Qxvi, Yhl, Yhl, Yhl, Yhl, Yhl, Yhl, Yhl, Yhl, Yhl, Qxvi, Qxvi
Qxvi, Qxvi, Yhl, Yhl, Yhl, Yhl, Yhl, Yhl, Yhl, Yhl, Yhl, Qxvi, Qxvi
Qxvi, Yhl, Xoav, Yhl, Yhl, Yhl, Qxvi^Bcv|, Yhl, Yhl, Yhl, Xoav, Yhl, Qxvi
Qxvi, Yhl, Yhl, Yhl, Qxvi^Bcv\, Qxvi, Yhl^Ii, Qxvi, Qxvi^Bcv/, Yhl, Yhl, Yhl, Qxvi
Qxvi, Qxvi, Qxvi, Qxvi, Qxvi, Yhl^Ii, 1 Yhl^Ii, Yhl^Ii, Qxvi, Qxvi, Qxvi, Qxvi, Qxvi
Qxvi, Qxvi, Qxvi, Qxvi, Qxvi, Qxvi, Qxvi, Qxvi, Qxvi, Qxvi, Qxvi, Qxvi, Qxvi
