Qxu, Qxu, Qxu, Qxu, Qxu, Qxu, Qxu, Qxu, Qxu, Qxu, Qxu, Qxu, Qxu
Qxu, Qxu, Qxu, Qxu, Qxu, Qxu, Ur, Qxu, Qxu, Qxu, Qxu, Qxu, Qxu
Qxu, Qxu, Ur, Qxu, Qxu^Bcx/, Ur, Ur, Ur, Qxu^Bcx\, Qxu, Ur, Qxu, Qxu
Qxu, Ur, Xoa, Ur, Qxu, Ur, Ur, Ur, Qxu, Ur, Xoa, Ur, Qxu
Qxu, Ur, Ur, Ur, Ur, Qxu, Qxu^Bcx|, Qxu, Ur, Ur, Ur, Ur, Qxu
Qxu, Qxu, Ur, Ur, Xoa, Ur, Ur, Ur, Xoa, Ur, Ur, Qxu, Qxu
Qxu, Qxu, Ur, Ur, Ur, Ur, Ur, Ur, Ur, Ur, Ur, Qxu, Qxu
Qxu, Qxu, Ur, Ur, Ur, Ur, Ur, Ur, Ur, Ur, Ur, Qxu, Qxu
Qxu, Ur, Xoa, Ur, Ur, Ur, Qxu^Bcx|, Ur, Ur, Ur, Xoa, Ur, Qxu
Qxu, Ur, Ur, Ur, Qxu^Bcx\, Qxu, Ur^Ii, Qxu, Qxu^Bcx/, Ur, Ur, Ur, Qxu
Qxu, Qxu, Qxu, Qxu, Qxu, Ur^Ii, 1 Ur^Ii, Ur^Ii, Qxu, Qxu, Qxu, Qxu, Qxu
Qxu, Qxu, Qxu, Qxu, Qxu, Qxu, Qxu, Qxu, Qxu, Qxu, Qxu, Qxu, Qxu
