Qxvi, Qxvi, Qxvi, Qxvi, Qxvi, Qxvi, Qxvi, Qxvi, Qxvi, Qxvi, Qxvi, Qxvi, Qxvi
Qxvi, Qxvi, Qxvi, Qxvi, Qxvi, Qxvi, Yhl, Qxvi, Qxvi, Qxvi, Qxvi, Qxvi, Qxvi
Qxvi, Qxvi, Qxvi, Qxvi, Yhl, Yhl, Yhl, Yhl, Yhl, Qxvi, Qxvi, Qxvi, Qxvi
Qxvi, Qxvi, Xoav, Yhl, Yhl, Yhl, Yhl, Yhl, Yhl, Yhl, Xoav, Qxvi, Qxvi
Qxvi, Qxvi, Yhl, Yhl, Yhl, Yhl, Yhl, Yhl, Yhl, Yhl, Yhl, Qxvi, Qxvi
Qxvi, Qxvi, Yhl, Yhl, Xoav, Yhl, Yhl, Yhl, Xoav, Yhl, Yhl, Qxvi, Qxvi
Qxvi, Qxvi, Yhl, Yhl, Yhl, Yhl, Yhl, Yhl, Yhl, Yhl, Yhl, Qxvi, Qxvi
Qxvi, Qxvi, Yhl, Yhl, Yhl, Yhl, Yhl, Yhl, Yhl, Yhl, Yhl, Qxvi, Qxvi
Qxvi, Qxvi, Xoav, Yhl, Yhl, Yhl, Yhl, Yhl, Yhl, Yhl, Xoav, Qxvi, Qxvi
Qxvi, Qxvi, Qxvi, Yhl, Yhl, Yhl, Yhl^Ii, Yhl, Yhl, Yhl, Qxvi, Qxvi, Qxvi
Qxvi, Qxvi, Qxvi, Qxvi, Qxvi, Yhl^Ii, 1 Yhl^Ii, Yhl^Ii, Qxvi, Qxvi, Qxvi, Qxvi, Qxvi
Qxvi, Qxvi, Qxvi, Qxvi, Qxvi, Qxvi, Qxvi, Qxvi, Qxvi, Qxvi, Qxvi, Qxvi, Qxvi
