Xoav, Xoav, Xoav, Xoav, Xoav, Xoav, Xoav, Xoav, Xoav, Xoav, Xoav, Xoav, Xoav
Xoav, Xoav, Xoav, Xoav, Xoav, Xoav, Yhl, Xoav, Xoav, Xoav, Xoav, Xoav, Xoav
Xoav, Xoav, Xoav, Xoav, Qxvi, Yhl, Yhl, Yhl, Qxvi^Bcv\, Xoav, Xoav, Xoav, Xoav
Xoav, Xoav, Yhl, Yhl, Qxvi, Yhl, Yhl, Yhl, Qxvi, Yhl, Yhl, Xoav, Xoav
Xoav, Xoav, Qxvi, Yhl, Qxvi, Qxvi, Qxvi, Qxvi, Qxvi^Bcv/, Yhl, Yhl, Xoav, Xoav
Xoav, Xoav, Yhl^Pop, Qxvi^Bcv|, Qxvi, Qxvi, Yhl, Qxvi^Bcv/, Qxvi, Qxvi, Qxvi, Xoav, Xoav
Xoav, Xoav, Yhl, Yhl, Qxvi^Bcv\, Qxvi, Yhl, Yhl, Qxvi, Qxvi, Qxvi, Xoav, Xoav
Xoav, Xoav, Qxvi, Yhl, Qxvi, Qxvi^Bcv\, Yhl, Yhl, Qxvi, Qxvi, Yhl, Xoav, Xoav
Xoav, Xoav, Qxvi, Qxvi, Qxvi, Qxvi, Qxvi, Qxvi, Qxvi^Bcv/, Yhl, Yhl^Pop, Xoav, Xoav
Xoav, Xoav, Xoav, Qxvi, Qxvi, Qxvi, Yhl^Ii, Qxvi^Bcv/, Qxvi, Qxvi, Xoav, Xoav, Xoav
Xoav, Xoav, Xoav, Xoav, Xoav, Yhl^Ii, 1 Yhl^Ii, Yhl^Ii, Xoav, Xoav, Xoav, Xoav, Xoav
Xoav, Xoav, Xoav, Xoav, Xoav, Xoav, Xoav, Xoav, Xoav, Xoav, Xoav, Xoav, Xoav
