Qxvi, Qxvi, Qxvi, Qxvi, Qxvi, Qxvi, Qxvi, Qxvi, Qxvi, Qxvi, Qxvi, Qxvi, Qxvi
Qxvi, Qxvi, Xoav, Xoav, Qxvi, Qxvi, Yhl, Qxvi, Qxvi, Xoav, Xoav, Qxvi, Qxvi
Qxvi, Qxvi, Qxvi, Qxvi, Yhl, Yhl, Yhl, Yhl, Yhl, Qxvi, Qxvi, Qxvi, Qxvi
Qxvi, Qxvi, Qxvi, Yhl, Yhl, Yhl, Yhl, Yhl, Yhl, Yhl, Qxvi, Qxvi, Qxvi
Qxvi, Xoav, Yhl, Qxvi^Bcv/, Qxvi, Yhl, Yhl, Yhl, Qxvi, Qxvi^Bcv\, Yhl, Xoav, Qxvi
Qxvi, Xoav, Yhl, Yhl, Yhl, Qxvi, Qxvi, Qxvi, Yhl, Yhl, Yhl, Xoav, Qxvi
Qxvi, Xoav, Yhl, Yhl, Yhl, Yhl, Qxvi, Yhl, Yhl, Yhl, Yhl, Xoav, Qxvi
Qxvi, Xoav, Yhl, Yhl, Qxvi, Qxvi, Yhl, Qxvi, Qxvi, Yhl, Yhl, Xoav, Qxvi
Qxvi, Xoav, Qxvi, Qxvi^Bcv|, Yhl, Yhl, Yhl, Yhl, Yhl, Qxvi^Bcv|, Qxvi, Xoav, Qxvi
Qxvi, Qxvi, Qxvi, Yhl, Yhl, Yhl, Yhl^Ii, Yhl, Yhl, Yhl, Qxvi, Qxvi, Qxvi
Qxvi, Qxvi, Qxvi, Qxvi, Qxvi, Yhl^Ii, 1 Yhl^Ii, Yhl^Ii, Qxvi, Qxvi, Qxvi, Qxvi, Qxvi
Qxvi, Qxvi, Qxvi, Qxvi, Qxvi, Qxvi, Qxvi, Qxvi, Qxvi, Qxvi, Qxvi, Qxvi, Qxvi
