Xue, Xue, Xue, Xue, Xue, Xue, Xue, Xue, Xue, Xue, Xue, Xue, Xue
Xue, Xue, Xue, Xue, Xue, Xue, Xue, Xue, Xue, Xue, Xue, Xue, Xue
Xue, Xue, Xue, Xue, Dd, Rd, Rd, Rd, Dd, Xue, Xue, Xue, Xue
Xue, Xue, Mdd, Mdd, Hd, Rd, Rd, Rd, Hd, Mdd, Mdd, Xue, Xue
Xue, Xue, Qxe, Mdd, Cdr, Dd^Edp, Rd, Dd, Cdr, Mdd, Qxe, Xue, Xue
Xue, Xue, Dd, Qxe, Qxe, Kdr, Rd, Kdr, Qxe, Qxe, Dd, Xue, Xue
Xue, Xue, Dd^Edp, Dd, Dd, Xue, Rd, Xue, Dd, Dd, Dd, Xue, Xue
Xue, Xue, Mdd, Dd, Dd, Dd, Rd, Dd, Dd, Dd, Mdd, Xue, Xue
Xue, Xue, Mdd^Xm, Hd, Dd^Edp, Dd, Rd, Dd^Edp, Dd, Hd^Edp, Mdd^Xm, Xue, Xue
Xue, Xue, Xue, Mdd, Dd, Dd, Rd, Dd, Dd, Mdd, Xue, Xue, Xue
Xue, Xue, Xue, Xue, Xue, Rd, 1 Rd, Rd, Xue, Xue, Xue, Xue, Xue
Xue, Xue, Xue, Xue, Xue, Xue, Rd, Xue, Xue, Xue, Xue, Xue, Xue
