Xue, Xue, Xue, Xue, Xue, Xue, Rd, Xue, Xue, Xue, Xue, Xue, Xue
Xue, Xue, Xue, Xue, Dd^Edpp, Dd, Rd, Dd, Dd, Xue, Xue, Xue, Xue
Xue, Xue, Dd^Ftd, Dd, Rd, Rd, Dd, Dd^Edpp, Dd, Hd, Mdd, Xue, Xue
Xue, Xue, Qxe, Dd^Ftd, Rd, Dd, Qxe, Qxe, Dd, Hd, Mdd, Mdd^Xm, Mdd^Xm
Xue, Qxe, Qxe, Dd^Ftd, Rd, Dd^Ftd, Qxe, Dd^Ftd, Dd^Dc, Hd, Cdr^Esd, Cdr^Esd, Cdr^Esd
Xue, Qxe, Qxe, Dd^Ftd, Rd, Dd, Dd, Dd, Dd^Edpp, Rd, Cdr^Esd, Kdr^Dr, Cdr^Esd
Xue, Qxe, Qxe, Dd^Ftd, Rd, Dd, Qxe, Dd^Esd, Dd, Dd^Vdr, Mdd, Cdr^Esd, Mdd^Xm
Xue, Qxe, Qxe, Dd^Ftd, Rd, Dd^Ftd, Qxe, Dd^Ftd, Dd, Hd, Mdd, Mdd^Xm, Xue
Xue, Xue, Dd^Ftd, Dd^Ftd, Rd, Dd, Dd, Qxe, Dd^Edpp, Hd, Hd, Mdd, Xue
Xue, Xue, Xue, Dd, Dd, Rd, Ur^Ii, Dd, Dd, Dd, Xue, Xue, Xue
Xue, Xue, Xue, Xue, Xue, Ur^Ii, 1 Ur^Ii, Ur^Ii, Xue, Xue, Xue, Xue, Xue
Xue, Xue, Xue, Xue, Xue, Xue, Rd, Xue, Xue, Xue, Xue, Xue, Xue
