Xue, Xue, Xue, Xue, Xue, Xue, Xue, Xue, Xue, Xue, Xue, Xue, Xue
Xue, Xue, Xue, Xue, Xue, Xue, Xue, Xue, Xue, Xue, Xue, Xue, Xue
Xue, Xue, Xue, Xue, Dd^Ftd, Dd^Ftd, Rd, Dd^Ftd, Dd^Ftd, Xue, Xue, Xue, Xue
Xue, Xue, Dd^Ftd, Dd^Ftd, Dd^Ftd, Cdr, Rd, Cdr, Dd^Ftd, Dd^Ftd, Dd^Ftd, Xue, Xue
Xue, Xue, Dd^Ftd, Dd^Ftd, Dd^Esd, Dd, Rd, Dd, Dd^Esd, Dd^Ftd, Dd^Ftd, Xue, Xue
Xue, Xue, Dd, Dd^Esd, Rd^Esd, Rd, Qxe, Rd, Rd^Esd, Dd^Esd, Dd^Edpp, Xue, Xue
Xue, Xue, Dd, Rd, Dd^Vdr, Qxe, Qxe, Qxe, Dd^Vdr, Rd, Dd, Xue, Xue
Xue, Xue, Dd, Rd, Rd, Dd^Dr, Dd^Esd, Dd^Vdr, Rd, Rd, Dd, Xue, Xue
Xue, Xue, Qxe, Dd, Dd^Edpp, Rd, Rd, Rd^Esd, Dd, Dd, Qxe, Xue, Xue
Xue, Xue, Xue, Dd, Dd, Dd, Rd^Esd, Dd, Dd, Dd^Edpp, Xue, Xue, Xue
Xue, Xue, Xue, Xue, Xue, Rd^Esd, 1 Rd, Rd, Xue, Xue, Xue, Xue, Xue
Xue, Xue, Xue, Xue, Xue, Xue, Rd, Xue, Xue, Xue, Xue, Xue, Xue
