Xue, Xue, Xue, Xue, Xue, Xue, Rd, Xue, Xue, Xue, Xue, Xue, Xue
Xue, Xue, Xue, Xue, Xue, Xue, Rd, Xue, Xue, Xue, Xue, Xue, Xue
Xue, Xue, Xue, Xue, Dd, Rd, Rd, Rd, Dd, Xue, Xue, Xue, Xue
Xue, Xue, Dd^Fts, Dd^Fts, Dd, Dd^Edp, Rd, Dd, Dd^Edp, Dd^Edp, Dd, Xue, Xue
Xue, Dd^Fts, Xue, Xue, Xue, Dd, Dd, Rd, Rd, Dd^Edp, Hd, Hd, Xue
Xue, Dd^Fts, Dd^Fts, Dd, Dd, Dd, Dd, Dd, Hd, Rd, Mdd, Mdd, Xue
Xue, Dd^Fts, Dd, Dd, Dd^Edpp, Dd, Qxe, Qxe, Mdd, Rd, Mdd, Mdd^Xm, Xue
Xue, Dd^Fts, Dd^Fts, Dd, Dd, Dd, Qxe, Mdd^Xm, Mdd, Rd, Mdd, Mdd^Xm, Xue
Xue, Dd^Fts, Dd^Fts, Xue, Dd, Hd, Hd, Mdd, Rd, Rd, Mdd, Mdd^Xm, Xue
Xue, Xue, Xue, Dd, Dd^Edp, Dd, Rd, Rd, Hd, Mdd, Xue, Xue, Xue
Xue, Xue, Xue, Xue, Xue, Rd, 1 Rd, Rd, Xue, Xue, Xue, Xue, Xue
Xue, Xue, Xue, Xue, Xue, Xue, Rd, Xue, Xue, Xue, Xue, Xue, Xue
