Xue, Xue, Xue, Xue, Xue, Xue, Xue, Xue, Xue, Xue, Xue, Xue, Xue
Xue, Xue, Xue, Xue, Dd, Dd, Dd, Dd, Dd^Edpp, Xue, Xue, Xue, Xue
Xue, Xue, Dd, Dd, Dd^Fts, Dd, Dd, Dd, Dd, Dd^Esd, Dd^Esd, Xue, Xue
Xue, Xue, Dd, Dd, Wwt, Dd^Fts, Wwt, Dd, Dd^Edpp, Xue, Dd^Esd, Xue, Xue
Dd, Xue, Dd, Wwf, Ds, Wwt, Ds, Ds, Dd, Dd, Dd, Xue, Dd
Rd, Dd, Rd, Dd, Rd, Gs^Efm, Cd, Gs^Efm, Rd, Rd, Rd, Rd, Rd
Dd, Rd, Dd, Rd, Dd, Gs^Efm, Ds, Gs^Efm, Ds, Dd, Dd, Dd, Dd
Xue, Xue, Dd^Esd, Dd, Dd^Edpp, Ds, Wwt, Wwt, Wwt, Wwf, Dd, Xue, Xue
Xue, Xue, Dd^Esd, Xue, Dd, Dd, Dd, Dd^Fts, Dd^Fts, Dd, Dd, Xue, Xue
Xue, Xue, Xue, Dd^Esd, Dd^Edpp, Dd, Ur^Ii, Dd, Dd, Dd, Xue, Xue, Xue
Xue, Xue, Xue, Xue, Xue, Ur^Ii, 1 Ur^Ii, Ur^Ii, Xue, Xue, Xue, Xue, Xue
Xue, Xue, Xue, Xue, Xue, Xue, Xue, Xue, Xue, Xue, Xue, Xue, Xue
