Xu, Xu, Xu, Xu, Xu, Xu, Xu, Xu, Xu, Xu, Xu, Xu, Xu
Xu, Xu, Xu, Xu, Uu^Emf, Uu, Uu, Uu, Uu, Xu, Xu, Xu, Urb^Br/
Xu, Xu, Uu^Tf, Uu^Tf, Uu^Emf, Uu, Uu, Uu, Uu, Uu, Urb^Br/, Urb^Br/, Xu
Xu, Xu, Uu^Tf, Uu^Vud, Uu^Emf, Uu, Uu, Uu, Urb^Br/, Urb^Br/, Uu, Xu, Xu
Xu, Xu, Uu^Emf, Uu^Emf, Qxu, Qxu, Urb^Br|, Urb^Br/, Qxu, Uu, Uu, Xu, Xu
Xu, Xu, Uu, Uu, Qxu, Qxu, Urb^Br|, Qxu, Qxu, Uu, Uu, Xu, Xu
Xu, Xu, Uu, Uu, Qxu, Qxu, Urb^Br|, Qxu, Qxu, Uu, Uu^Emf, Xu, Xu
Xu, Xu, Uu, Uu, Urb^Br/, Urb^Br/, Uu, Qxu, Uu^Emf, Uu^Emf, Uu^Tf, Xu, Xu
Xu, Xu, Urb^Br/, Urb^Br/, Uu, Uu, Uu, Uu, Uu^Emf, Uu^Vud, Uu^Tf, Xu, Xu
Urb^Br/, Urb^Br/, Xu, Uu, Uu, Uu, Ur^Ii, Uu, Uu^Emf, Uu^Tf, Xu, Xu, Xu
Xu, Xu, Xu, Xu, Xu, Ur^Ii, 1 Ur^Ii, Ur^Ii, Xu, Xu, Xu, Xu, Xu
Xu, Xu, Xu, Xu, Xu, Xu, Xu, Xu, Xu, Xu, Xu, Xu, Xu
