Xue, Xue, Xue, Xue, Xue, Xue, Xue, Xue, Xue, Xue, Xue, Xue, Xue
Xue, Xue, Xue, Xue, Xue, Xue, Rp, Xue, Xue, Xue, Xue, Xue, Xue
Xue, Xue, Xue, Xue, Re, Rp, Rp, Rp, Re, Xue, Xue, Xue, Xue
Xue, Xue, Wwt, Ds, Re, Rp, Rp, Rp, Re, Ds, Wwt, Xue, Xue
Xue, Xue, Wwt, Ds, Gll, Re, Re, Re, Gll, Ds, Wwt, Xue, Xue
Xue, Xue, Ds, Ds, Gll, Gll^Ftr, Gll^Ftr, Gll^Ftr, Gll, Ds, Ds, Xue, Xue
Xue, Xue, Gll, Gll, Gll, Gll, Gll^Ftr, Gll, Gll, Gll, Gll, Xue, Xue
Xue, Xue, Ds, Gll^Ftr, Gll^Ftr, Gll, Gll, Gll, Gll^Ftr, Gll^Ftr, Ds, Xue, Xue
Xue, Xue, Wwt, Ds, Gll^Ftr, Gll, Re, Gll, Gll^Ftr, Ds, Wwt, Xue, Xue
Xue, Xue, Xue, Ds, Re, Re, Ur^Ii, Re, Re, Ds, Xue, Xue, Xue
Xue, Xue, Xue, Xue, Xue, Ur^Ii, 1 Ur^Ii, Ur^Ii, Xue, Xue, Xue, Xue, Xue
Xue, Xue, Xue, Xue, Xue, Xue, Xue, Xue, Xue, Xue, Xue, Xue, Xue
