Xue, Xue, Xue, Xue, Xue, Xue, Xue, Xue, Xue, Xue, Xue, Xue, Xue
Xue, Xue, Xue, Xue, Xue, Xue, Rp, Xue, Xue, Xue, Xue, Xue, Xue
Xue, Xue, Xue, Xue, Re, Rp, Rp, Rp, Re, Xue, Xue, Xue, Xue
Xue, Xue, Gll^Ftr, Gll^Ftr, Re, Rp, Rp, Rp, Re, Gll^Ftr, Gll^Ftr, Xue, Xue
Xue, Xue, Gll^Ftr, Gll^Ftr, Gll, Re, Re, Re, Gll, Gll^Ftr, Gll^Ftr, Xue, Xue
Xue, Xue, Gll, Gll, Gll, Gll, Gll, Gll, Gll, Gll, Gll, Xue, Xue
Xue, Xue, Gll, Gll, Gll^Ftr, Ss, Rr^Vd, Ss, Gll^Ftr, Gll, Gll, Xue, Xue
Xue, Xue, Gll, Gll^Ftr, Gll^Ftr, Ss, Gll, Ss, Gll^Ftr, Gll^Ftr, Gll, Xue, Xue
Xue, Xue, Gll^Ftr, Gll, Gll, Gll, Re, Gll, Gll, Gll, Gll^Ftr, Xue, Xue
Xue, Xue, Xue, Gll^Ftr, Re, Re, Ur^Ii, Re, Re, Gll^Ftr, Xue, Xue, Xue
Xue, Xue, Xue, Xue, Xue, Ur^Ii, 1 Ur^Ii, Ur^Ii, Xue, Xue, Xue, Xue, Xue
Xue, Xue, Xue, Xue, Xue, Xue, Xue, Xue, Xue, Xue, Xue, Xue, Xue
