Xyui, Xyui, Xyui, Xyui, Xyui, Xyui, Xyui, Xyui, Xyui, Xyui, Xyui, Xyui, Xyui
Xyui, Xyui, Xyui, Xyui, Xyui, Xyui, Xyui, Xyui, Xyui, Xyui, Xyui, Xyui, Xyui
Xyui, Xyui, Qxaz, Qxaz, Aa, Aa, Aa, Aa, Aa, Qxaz, Qxaz, Xyui, Xyui
Xyui, Xyui, Qxaz, Aa, Aa, Aa, Aa, Aa, Aa, Aa, Qxaz, Xyui, Xyui
Xyui, Xyui, Aa, Aa, Ha, Ha^Fpa, Ha^Fpa, Ha, Ha^Fpa, Aa, Aa, Xyui, Xyui
Xyui, Xyui, Aa, Aa, Ha, Ms, Ms^Xm, Ms, Ha, Aa, Aa, Xyui, Xyui
Xyui, Xyui, Aa, Aa, Ha, Ms^Xm, Ms^Xm, Ms, Ms, Ha, Aa, Xyui, Xyui
Xyui, Xyui, Aa^Fpa, Aa, Aa, Ha, Ha, Ms, Ha^Fpa, Ha^Fpa, Aa, Xyui, Xyui
Xyui, Xyui, Aa^Fpa, Aa^Fpa, Aa, Aa, Aa, Ha^Fpa, Aa, Aa, Aa, Xyui, Xyui
Xyui, Xyui, Aa^Fpa, Aa^Fpa, Aa, Aa, Rra, Aa, Aa, Aa, Qxaz, Xyui, Xyui
Xyui, Xyui, Xyui, Xyui, Xyui, Rra, 1 Rra, Rra, Xyui, Xyui, Xyui, Xyui, Xyui
Xyui, Xyui, Xyui, Xyui, Xyui, Xyui, Xyui, Xyui, Xyui, Xyui, Xyui, Xyui, Xyui
