Xyui, Xyui, Xyui, Xyui, Xyui, Xyui, Xyui, Xyui, Xyui, Xyui, Xyui, Xyui, Xyui
Xyui, Xyui, Xyui, Xyui, Xyui, Xyui, Xyui, Xyui, Xyui, Xyui, Xyui, Xyui, Xyui
Xyui, Xyui, Xyui, Xyui, Ha^Fpa, Ha^Fpa, Aa, Ha^Fpa, Ha^Fpa, Xyui, Xyui, Xyui, Xyui
Xyui, Xyui, Aa, Ha^Fpa, Ha, Aa, Aa, Aa, Ha, Ha^Fpa, Aa, Xyui, Xyui
Xyui, Xyui, Qxaz, Aa, Aa, Aa, Kea, Aa, Aa, Aa, Qxaz, Xyui, Xyui
Xyui, Xyui, Qxaz, Xyui, Aa, Kea, Coa^Ecf, Kea, Aa, Xyui, Qxaz, Xyui, Xyui
Xyui, Xyui, Qxaz, Qxaz, Aa, Kea, Kea, Kea, Aa, Qxaz, Qxaz, Xyui, Xyui
Xyui, Xyui, Aa, Qxaz, Qxaz, Aa, Aa, Aa, Qxaz, Qxaz, Aa, Xyui, Xyui
Xyui, Xyui, Aa, Aa, Aa, Aa, Aa, Aa, Aa, Aa, Aa, Xyui, Xyui
Xyui, Xyui, Xyui, Aa, Ha, Aa, Rra, Aa, Ha, Aa, Xyui, Xyui, Xyui
Xyui, Xyui, Xyui, Xyui, Xyui, Rra, 1 Rra, Rra, Xyui, Xyui, Xyui, Xyui, Xyui
Xyui, Xyui, Xyui, Xyui, Xyui, Xyui, Xyui, Xyui, Xyui, Xyui, Xyui, Xyui, Xyui
