Xyui, Xyui, Xyui, Xyui, Xyui, Xyui, Xyui, Xyui, Xyui, Xyui, Xyui, Xyui, Xyui
Xyui, Xyui, Xyui, Xyui, Xyui, Xyui, Xyui, Xyui, Xyui, Xyui, Xyui, Xyui, Xyui
Xyui, Xyui, Xyui, Xyui, Qxaz, Ai, Aa, Ai, Qxaz, Xyui, Xyui, Xyui, Xyui
Xyui, Xyui, Qxaz, Qxaz, Xos, Aa, Rra, Aa, Xos, Qxaz, Qxaz, Xyui, Xyui
Xyui, Xyui, Ai, Xos, Rra, Rra, Xos, Rra, Rra, Xos, Ai, Xyui, Xyui
Xyui, Xyui, Ai, Aa^Fpa, Rra, Rb, Rb^Ecf, Rb, Rra, Aa^Fpa, Ai, Xyui, Xyui
Xyui, Xyui, Qxaz, Xos, Rra, Rb, Qxu, Rb, Rra, Xos, Qxaz, Xyui, Xyui
Xyui, Xyui, Qxaz, Xos, Xos, Rra, Rra, Rra, Xos, Xos, Qxaz, Xyui, Xyui
Xyui, Xyui, Ai, Ai, Aa, Aa, Koa, Aa, Aa, Ai, Ai, Xyui, Xyui
Xyui, Xyui, Xyui, Ai, Ai, Aa, Rra, Aa, Ai, Ai, Xyui, Xyui, Xyui
Xyui, Xyui, Xyui, Xyui, Xyui, Rra, 1 Rra, Rra, Xyui, Xyui, Xyui, Xyui, Xyui
Xyui, Xyui, Xyui, Xyui, Xyui, Xyui, Xyui, Xyui, Xyui, Xyui, Xyui, Xyui, Xyui
