Xyui, Xyui, Xyui, Xyui, Xyui, Xyui, Xyui, Xyui, Xyui, Xyui, Xyui, Xyui, Xyui
Xyui, Xyui, Xyui, Xyui, Xyui, Xyui, Xyui, Xyui, Xyui, Xyui, Xyui, Xyui, Xyui
Xyui, Xyui, Ms^Xm, Ha, Rra, Rra, Rra, Rra, Rra, Xyui, Xyui, Xyui, Xyui
Xyui, Xyui, Ha, Ha, Aa, Rra, Rra, Rra, Aa, Ha, Ha, Xyui, Xyui
Xyui, Xyui, Qxaz, Aa, Xos, Rra, Xos, Aa, Ai, Ha, Ai, Xyui, Xyui
Xyui, Xyui, Qxaz, Xos, Rb, Rb, Rb, Xos, Ai, Ai, Qxaz, Xyui, Xyui
Xyui, Xyui, Qxaz, Xos, Rb, Rb^Ecf, Rb, Rra, Ai, Qxaz, Qxaz, Xyui, Xyui
Xyui, Xyui, Qxaz, Xos, Xos, Rb, Xos, Xos, Ai, Qxaz, Qxaz, Xyui, Xyui
Xyui, Xyui, Ha, Aa, Aa, Rra, Aa, Aa, Ai, Ai, Ai, Xyui, Xyui
Xyui, Xyui, Ms^Xm, Ha, Aa, Rra, Rra, Aa, Ai, Ha, Ha, Xyui, Xyui
Xyui, Xyui, Xyui, Ha, Xyui, Rra, 1 Rra, Rra, Xyui, Ha, Xyui, Xyui, Xyui
Xyui, Xyui, Xyui, Xyui, Xyui, Xyui, Xyui, Xyui, Xyui, Xyui, Xyui, Xyui, Xyui
