Xyui, Xyui, Xyui, Xyui, Xyui, Xyui, Xyui, Xyui, Xyui, Xyui, Xyui, Xyui, Xyui
Xyui, Xyui, Xyui, Xyui, Xyui, Xyui, Xyui, Xyui, Xyui, Xyui, Xyui, Xyui, Xyui
Xyui, Xyui, Ai, Aa, Ai, Ai, Aa, Ai, Ai, Aa, Ai, Xyui, Xyui
Xyui, Xyui, Ai, Ai, Xos, Aa, Aa, Aa, Xos, Ai, Ai, Xyui, Xyui
Xyui, Xyui, Ai, Xos, Gd^Ii, Xos, Gd^Ii, Xos, Gd^Ii, Xos, Ai, Xyui, Xyui
Xyui, Xyui, Ai, Xos, Qxu^Ii, Gd^Ii, Gg^Fet, Gd^Ii, Qxu^Ii, Xos, Ai, Xyui, Xyui
Xyui, Xyui, Ai, Aa^Pob, Qxu^Ii, Gd^Ii, Gd^Pog, Gd^Ii, Qxu^Ii, Aa^Pob, Ai, Xyui, Xyui
Xyui, Xyui, Ai, Xos, Gd^Ii, Qxu^Ii, Qxu^Ii, Qxu^Ii, Gd^Ii, Xos, Ai, Xyui, Xyui
Xyui, Xyui, Ha, Aa, Xos, Gd^Ii, Aa^Pog, Gd^Ii, Xos, Aa, Ha, Xyui, Xyui
Xyui, Xyui, Ha, Ha, Ms^Xm, Xos, Rra, Xos, Ms^Xm, Ha, Ha, Xyui, Xyui
Xyui, Xyui, Xyui, Xyui, Xyui, Rra, 1 Rra, Rra, Xyui, Xyui, Xyui, Xyui, Xyui
Xyui, Xyui, Xyui, Xyui, Xyui, Xyui, Xyui, Xyui, Xyui, Xyui, Xyui, Xyui, Xyui
