Xyui, Xyui, Xyui, Xyui, Xyui, Xyui, Xyui, Xyui, Xyui, Xyui, Xyui, Xyui, Xyui
Xyui, Xyui, Xyui, Xyui, Xyui, Xyui, Xyui, Xyui, Xyui, Xyui, Xyui, Xyui, Xyui
Xyui, Xyui, Xyui, Xyui, Aa, Aa, Aa, Aa, Aa, Xyui, Xyui, Xyui, Xyui
Xyui, Xyui, Aa^Fpa, Aa^Fpa, Aa, Aa, Aa, Aa, Aa, Aa, Aa, Xyui, Xyui
Xyui, Xyui, Aa^Fpa, Aa^Feta, Aa, Ha, Qxaz, Ha, Aa, Aa, Aa, Qxaz, Xyui
Xyui, Xyui, Aa, Aa, Ha, Qxaz, Aa^Feth, Qxaz, Ha, Aa, Aa, Qxaz, Xyui
Xyui, Xyui, Aa, Aa, Aa, Qxaz, Qxaz, Qxaz, Aa, Aa, Aa, Xyui, Xyui
Xyui, Qxaz, Aa, Aa, Aa, Ha, Aa, Ha, Aa, Aa, Aa^Fpa, Xyui, Xyui
Xyui, Qxaz, Aa, Aa, Aa, Aa, Aa, Aa, Aa, Aa^Feta, Aa^Fpa, Xyui, Xyui
Xyui, Xyui, Xyui, Aa, Aa, Aa, Rra, Aa, Aa, Aa^Fpa, Xyui, Xyui, Xyui
Xyui, Xyui, Xyui, Xyui, Xyui, Rra, 1 Rra, Rra, Xyui, Xyui, Xyui, Xyui, Xyui
Xyui, Xyui, Xyui, Xyui, Xyui, Xyui, Xyui, Xyui, Xyui, Xyui, Xyui, Xyui, Xyui
