Xue, Xue, Xue, Xue, Xue, Xue, Xue, Xue, Xue, Xue, Xue, Xue, Xue
Xue, Xue, Xue, Xue, Gd, Gd, Gd, Gd, Gd, Xue, Xue, Xue, Xue
Xue, Xue, Uue, Gd, Gd, Gd, Gd, Gd, Gd, Gd^Emf, Tb^Tf, Xue, Xue
Xue, Xue, Uue^Emf, Uue^Emf, Qxe, Uue^Emf, Uue^Emf, Uue, Uue, Uue^Emf, Tb^Tf, Xue, Xue
Xue, Xue, Uue^Emf, Ss, Ss, Ss, Tb^Tf, Uue, Uue^Emf, Ss, Ss, Xue, Xue
Xue, Xue, Uue^Emf, Tb^Tf, Ss, Uue^Vu, Tb^Tf, Tb^Tf, Ss, Uue^Emf, Uue^Emf, Xue, Xue
Xue, Xue, Ss, Uue^Emf, Uue^Emf, Tb^Tf, Tb^Tf, Uue^Vu, Ss, Tb^Tf, Uue^Emf, Xue, Xue
Xue, Xue, Tb^Tf, Ss, Uue, Uue, Uue^Emf, Ss, Qxe, Ss, Uue^Emf, Xue, Xue
Xue, Xue, Tb^Tf, Uue^Emf, Gd, Uue, Gd, Uue^Emf, Gd, Uue^Emf, Uue, Xue, Xue
Xue, Xue, Xue, Gd^Emf, Gd, Gd, Ur^Ii, Gd, Gd, Gd, Xue, Xue, Xue
Xue, Xue, Xue, Xue, Xue, Ur^Ii, 1 Ur^Ii, Ur^Ii, Xue, Xue, Xue, Xue, Xue
Xue, Xue, Xue, Xue, Xue, Xue, Xue, Xue, Xue, Xue, Xue, Xue, Xue
