Qxe, Xue, Xue, Xue, Xue, Xue, Rd, Xue, Xue, Xue, Xue, Xue, Qxe
Qxe, Qxe, Qxe, Xue, Dd, Dd, Rd, Dd, Dd^Edp, Xue, Qxe, Qxe, Qxe
Xue, Qxe, Dd, Dd^Edp, Dd, Dd, Rd, Dd, Dd, Dd, Dd, Qxe, Xue
Xue, Xue, Dd, Dd, Qxe, Qxe, Rd, Qxe, Qxe, Dd^Edp, Dd, Xue, Xue
Qxe, Xue, Dd, Dd, Qxe, Cdr, Rd, Cdr, Qxe^Bs/, Dd, Dd, Xue, Rd
Qxe, Qxe, Rd, Rd, Kdr, Rd^Vdr, Xue, Rd^Vdr, Kdr, Qxe, Rd, Rd, Qxe
Rd, Rd, Dd^Edp, Qxe, Qxe^Bs/, Rd, Rd^Vdr, Rd, Qxe, Rd, Dd^Edp, Qxe, Qxe
Qxe, Qxe, Dd, Dd, Qxe, Cdr, Rd, Cdr, Qxe, Dd, Dd, Qxe, Qxe
Qxe, Qxe, Xue, Dd, Dd, Qxe, Rd, Qxe, Dd, Dd, Xue, Qxe, Qxe
Qxe, Xue, Qxe, Dd, Dd, Dd, Rd, Dd, Dd, Dd^Edp, Qxe, Xue, Qxe
Qxe, Xue, Xue, Xue, Xue, Ds, 1 Rd, Ds, Xue, Xue, Xue, Xue, Qxe
Qxe, Qxe, Xue, Xue, Xue, Xue, Rd, Xue, Xue, Xue, Xue, Qxe, Qxe
