Xue, Xue, Xue, Xue, Xue, Xue, Xue, Xue, Xue, Xue, Xue, Xue, Xue
Xue, Xue, Xue, Xue, Xue, Xue, Xue, Xue, Xue, Xue, Xue, Xue, Xue
Xue, Xue, Xue, Xue, Dd, Dd, Dd, Dd, Dd, Xue, Xue, Xue, Xue
Xue, Xue, Qxe, Xue, Dd^Edp, Dd, Dd, Dd^Edp, Dd, Xue, Qxe, Xue, Xue
Xue, Xue, Qxe, Dd, Dd, Dd, Dd, Dd, Dd, Dd, Qxe, Xue, Xue
Xue, Xue, Xue, Dd, Dd, Qxe, Qxe, Qxe, Dd, Dd, Xue, Xue, Xue
Xue, Xue, Dd^Edp, Dd, Dd, Ds, Wwt, Gd^Fts, Dd^Edpp, Dd, Dd, Xue, Xue
Qxe, Qxe, Qxe, Dd, Dd, Gd^Fts, Wwt, Gd, Dd, Dd, Qxe, Qxe, Qxe
Qxe, Qxe, Qxe, Dd, Dd, Gd, Gd^Fts, Ds, Dd, Dd^Edp, Qxe, Qxe, Qxe
Xue, Qxe, Qxe, Qxe, Dd, Dd, Ds, Dd, Dd, Qxe, Qxe, Qxe, Xue
Xue, Xue, Xue, Xue, Xue, Ds, 1 Ds, Ds, Xue, Xue, Xue, Xue, Xue
Xue, Xue, Xue, Xue, Xue, Xue, Xue, Xue, Xue, Xue, Xue, Xue, Xue
