Xue, Xue, Xue, Xue, Xue, Xue, Xue, Xue, Xue, Xue, Xue, Xue, Xue
Xue, Xue, Xue, Xue, Xue, Xue, Xue, Xue, Xue, Xue, Xue, Xue, Xue
Qxe, Xue, Qxe, Xue, Dd^Edp, Dd, Dd, Dd, Dd^Edp, Xue, Xue, Xue, Xue
Qxe, Qxe, Qxe, Dd, Dd, Dd, Dd, Dd, Qxe, Qxe, Hd, Xue, Xue
Qxe, Qxe, Dd^Edp, Dd, Dd^Ftd, Dd, Dd, Dd, Qxe, Hd, Mdd, Xue, Xue
Qxe, Qxe, Dd, Dd, Dd^Ftd, Dd^Vdr, Dd, Dd, Hd, Hd, Mdd, Xue, Xue
Qxe, Qxe, Dd, Dd, Dd, Dd^Ftd, Dd, Dd, Hd, Mdd, Mdd^Xm, Xue, Xue
Qxe, Qxe, Qxe, Dd, Dd, Dd, Dd, Hd, Mdd, Mdd, Mdd^Xm, Xue, Xue
Qxe, Qxe, Dd, Dd, Dd, Dd^Edp, Dd, Hd, Mdd, Mdd^Xm, Mdd^Xm, Xue, Xue
Qxe, Qxe, Xue, Dd^Edp, Dd, Dd, Ds, Hd, Hd, Mdd, Xue, Xue, Xue
Xue, Xue, Xue, Xue, Xue, Ds, 1 Ds, Ds, Xue, Xue, Xue, Xue, Xue
Xue, Xue, Xue, Xue, Xue, Xue, Xue, Xue, Xue, Xue, Xue, Xue, Xue
