Xue, Xue, Xue, Xue, Xue, Xue, Xue, Xue, Xue, Xue, Xue, Xue, Xue
Xue, Xue, Xue, Xue, Xue, Xue, Xue, Xue, Xue, Xue, Xue, Xue, Xue
Xue, Qxe, Qxe, Xue, Dd, Dd, Dd, Dd, Dd, Xue, Xue, Xue, Xue
Qxe, Qxe, Xue, Dd^Ftd, Dd, Dd, Dd^Edp, Dd, Dd, Dd^Ftd, Hd^Ftd, Xue, Xue
Xue, Qxe, Dd^Ftd, Dd, Dd, Dd, Dd, Dd, Qxe^Bs|, Qxe, Hd^Ftd, Xue, Xue
Xue, Xue, Dd, Dd, Dd, Qxe, Xue, Qxe, Qxe^Bs|, Dd, Hd, Xue, Xue
Xue, Xue, Hd, Dd, Qxe^Bs|, Hd, Xue, Hd, Dd, Dd, Dd, Xue, Xue
Xue, Xue, Hd^Ftd, Dd, Qxe^Bs|, Qxe, Qxe, Qxe, Dd, Dd^Edp, Dd^Ftd, Xue, Xue
Xue, Xue, Hd^Ftd, Qxe, Dd, Dd, Dd, Dd, Dd, Dd, Xue, Qxe, Qxe
Xue, Xue, Xue, Dd^Ftd, Dd, Dd, Ds, Dd^Edp, Dd, Dd^Ftd, Qxe, Qxe, Xue
Xue, Xue, Xue, Xue, Xue, Ds, 1 Ds, Ds, Xue, Xue, Xue, Qxe, Xue
Xue, Xue, Xue, Xue, Xue, Xue, Xue, Xue, Xue, Xue, Xue, Xue, Xue
