Xue, Xue, Xue, Xue, Xue, Xue, Xue, Xue, Xue, Xue, Xue, Xue, Xue
Xue, Xue, Xue, Xue, Xue, Xue, Xue, Xue, Xue, Xue, Xue, Xue, Xue
Xue, Xue, Xue, Xue, Dd, Dd^Edp, Dd, Dd, Dd, Xue, Xue, Xue, Xue
Xue, Xue, Dd^Edp, Dd, Dd, Dd, Dd, Dd, Dd, Dd, Hd, Xue, Xue
Xue, Xue, Dd, Dd, Xue, Dd, Dd, Dd^Fts, Dd^Fts, Dd, Hd, Hd, Xue
Xue, Xue, Dd^Edp, Dd, Dd^Fts, Xue, Dd, Dd, Dd, Dd, Dd, Hd, Xue
Xue, Xue, Dd, Dd, Dd^Fts, Dd^Fts, Dd, Xue, Xue, Xue, Dd, Xue, Xue
Xue, Hd, Hd, Dd, Dd, Dd, Dd, Xue, Dd, Dd^Edp, Dd, Xue, Xue
Xue, Hd^Fts, Hd^Fts, Hd^Fts, Dd, Dd, Dd, Dd, Dd^Fts, Dd, Xue, Xue, Xue
Xue, Hd^Fts, Hd^Fts, Dd^Fts, Dd, Dd, Ds, Dd, Dd, Dd, Xue, Xue, Xue
Xue, Xue, Xue, Xue, Xue, Ds, 1 Ds, Ds, Xue, Xue, Xue, Xue, Xue
Xue, Xue, Xue, Xue, Xue, Xue, Xue, Xue, Xue, Xue, Xue, Xue, Xue
