Xue, Xue, Xue, Xue, Xue, Xue, Xue, Xue, Xue, Xue, Xue, Xue, Xue
Xue, Xue, Xue, Xue, Xue, Xue, Xue, Xue, Xue, Xue, Qxe, Xue, Xue
Xue, Xue, Qxe, Qxe, Qxe, Uue^Emf, Uue^Em, Uue^Em, Sm, Sm^Tf, Sm^Tf, Xue, Xue
Xue, Xue, Wwf^Tf, Qxe, Wwf^Emf, Uue, Wwf, Uue, Sm, Uue^Em, Sm, Xue, Xue
Xue, Xue, Wwf^Tf, Sm, Xue, Wwf^Emf, Sm, Sm, Sm^Emf, Wwf, Uue^Emf, Xue, Xue
Xue, Xue, Wwf, Sm, Wwf, Uue^Em, Uue^Emf, Ss^Ii, Wwf^Emf, Wwf^Emf, Uue^Emf, Xue, Xue
Xue, Xue, Qxe, Uue^Emf, Sm^Tf, Ss^Ii, Wwf, Wwf, Uue^Em, Qxe, Qxe, Xue, Xue
Xue, Xue, Sm^Tf, Sm, Ss^Ii, Ss^Ii, Uue, Wwf, Wwf, Qxe, Uue^Tf, Xue, Xue
Xue, Xue, Ss^Ii, Uue^Emf, Wwf^Emf, Uue, Wwf, Ss^Ii, Sm, Uue^Tf, Sm^Tf, Xue, Xue
Xue, Xue, Qxe, Sm^Tf, Wwf, Wwf, Uue, Sm, Sm, Uue^Tf, Xue, Xue, Xue
Xue, Xue, Xue, Qxe, Xue, Uue, 1 Uue, Uue, Xue, Xue, Xue, Xue, Xue
Xue, Xue, Xue, Xue, Xue, Xue, Xue, Xue, Xue, Xue, Xue, Xue, Xue
