Xue, Xue, Xue, Xue, Xue, Xue, Xue, Xue, Xue, Xue, Xue, Xue, Xue
Xue, Xue, Xue, Xue, Xue, Xue, Xue, Xue, Xue, Xue, Xue, Xue, Xue
Xue, Xue, Xue, Xue, Xue, Sm^Tf, Uue, Uue, Wwf^Emf, Xue, Xue, Xue, Xue
Xue, Xue, Sm^Tf, Xue, Xue, Sm, Uue, Uue, Sm^Tf, Wwf^Emf, Wwf^Tf, Xue, Xue
Xue, Xue, Uue^Emf, Wwf^Emf, Wwf, Ss^Ii, Wwf, Wwf, Ss^Ii, Sm^Tf, Uue^Tf, Xue, Xue
Xue, Xue, Sm, Wwf^Emf, Uue, Uue, Uue^Emf, Wwf, Uue, Xue, Xue, Xue, Xue
Xue, Xue, Sm, Sm, Wwf, Uue^Emf, Xue, Wwf, Uue^Emf, Xue, Sm^Emf, Xue, Xue
Xue, Xue, Ss^Ii, Wwf^Emf, Wwf, Sm, Sm^Tf, Wwf, Ss^Ii, Ss^Ii, Sm^Tf, Xue, Xue
Xue, Xue, Sm^Tf, Wwf^Emf, Uue, Sm, Sm, Wwf, Sm, Ss^Ii, Sm^Tf, Xue, Xue
Xue, Xue, Xue, Sm, Uue, Uue, Ur, Uue, Uue, Sm^Emf, Xue, Xue, Xue
Xue, Xue, Xue, Xue, Xue, Ur, 1 Ur, Ur, Xue, Xue, Xue, Xue, Xue
Xue, Xue, Xue, Xue, Xue, Xue, Xue, Xue, Xue, Xue, Xue, Xue, Xue
