Xue, Xue, Xue, Xue, Xue, Xue, Xue, Xue, Xue, Xue, Xue, Xue, Xue
Xue, Xue, Xue, Xue, Xue, Xue, Wwf, Xue, Xue, Xue, Xue, Xue, Xue
Xue, Xue, Xue, Xue, Xue, Wwf, Uue, Uue^Emf, Xue, Xue, Xue, Xue, Xue
Qxe, Qxe, Ss^Ii, Sm^Tf, Xue, Sm^Ewl, Uue^Emf, Uue^Emf, Sm^Tf, Xue, Sm^Tf, Qxe, Xue
Qxe, Qxe, Sm^Tf, Wwf^Tf, Xue, Sm, Wwf, Wwf, Xue, Xue, Ss^Ii, Qxe, Xue
Qxe, Qxe, Qxe, Wwf^Emf, Wwf, Xue, Ss^Ii, Uue^Emf, Xue, Ss^Ii, Uue^Emf, Qxe, Xue
Qxe, Qxe, Sm^Ewl, Wwf, Uue, Ss^Ii, Ss^Ii, Uue, Uue, Wwf, Qxe, Xue, Xue
Qxe, Qxe, Ss^Ii, Qxe, Uue, Uue, Wwf^Emf, Uue^Emf, Sm, Uue^Emf, Sm, Qxe, Qxe
Qxe, Qxe, Ss^Tf, Uue^Emf, Qxe^Ii, Ss^Ii, Wwf^Emf, Wwf^Tf, Qxe^Ii, Wwf, Ss^Tf, Qxe, Qxe
Qxe, Qxe, Qxe, Uue^Emf, Qxe^Ii, Sm, Ur, Wwf^Emf, Qxe^Ii, Uue, Qxe, Qxe, Qxe
Xue, Qxe, Qxe, Qxe, Qxe, Ur, 1 Ur, Ur, Qxe, Qxe, Qxe, Qxe, Qxe
Xue, Xue, Xue, Qxe, Qxe, Qxe, Qxe, Qxe, Qxe, Qxe, Qxe, Qxe, Qxe
