Xue, Xue, Xue, Xue, Xue, Xue, Xue, Xue, Xue, Xue, Xue, Xue, Xue
Xue, Xue, Xue, Xue, Xue, Xue, Xue, Xue, Xue, Xue, Xue, Xue, Xue
Xue, Xue, Sm, Sm, Sm, Uue^Emf, Uue, Uue, Wwf^Emf, Xue, Xue, Xue, Xue
Xue, Xue, Ss^Ii, Tb^Tf, Wwf^Emf, Uue^Emf, Uue, Uue, Wwf^Emf, Tb^Tf, Sm, Xue, Xue
Xue, Xue, Uue, Wwf^Emf, Wwf, Uue, Wwf^Emf, Qxe, Qxe, Sm, Ss^Ii, Xue, Xue
Xue, Xue, Xue, Uue, Qxe, Wwf^Emf, Wwf^Emf, Wwf^Emf, Sm, Uue^Emf, Tb^Tf, Xue, Xue
Xue, Xue, Xue, Uue, Qxe, Sm, Wwf^Emf, Wwf^Emf, Uue^Emf, Qxe, Qxe, Xue, Xue
Xue, Xue, Wwf, Wwf^Emf, Ss^Ii, Ss^Ii, Qxe, Uue, Tb^Tf, Tb^Tf, Tb^Tf, Xue, Xue
Xue, Xue, Wwf^Emf, Wwf, Wwf^Emf, Ss^Ii, Uue^Emf, Uue, Wwf^Tf, Ss^Ii, Tb^Tf, Qxe, Xue
Xue, Xue, Xue, Wwf^Emf, Wwf^Emf, Uue^Emf, Ur, Uue^Emf, Wwf^Emf, Tb^Tf, Qxe, Qxe, Xue
Xue, Xue, Xue, Xue, Xue, Ur, 1 Ur, Ur, Xue, Xue, Xue, Xue, Xue
Xue, Xue, Xue, Xue, Xue, Xue, Xue, Xue, Xue, Xue, Xue, Xue, Xue
